sentence	label
차인표 연기는 너무 현실적이여서 마음에 와닿는다 왕초드라마를볼때도 난 연기를하는건지 진짜 실제로 그러는건지 몰랐다 이영화 내용이 쥐어짜는스토리지만 차인표라는 배우때문에 영화가살았다 너무 현실적인 연기력이다 대단하다 눈물한방울 흘리지않았지만 마음이아팠다	연기력
이렇게 못 만들기가 더 어렵겠다. 초딩 학예회급 연기력을 선보인 이요원은 모구 게다가 황정민 딸로 나온 아주머니는 모냐? 감독이나 제작진은 몰보구 캐스팅들을한 거냐? 한심한 영화네... 네이버두 별점 0개 할 수 있게 해주세요	연기력
권선징악이라는 진부한 스토리..하지만 드라마 중반부까진 10점 주어도 괜찮을듯한 연출 스토리 연기력. 후반부 갈수록 누구나 예상가능한 권선징악결론이겠지만 왜인지..예상못할 훌륭한 반전 하나정도 나오지 않을까하는 개인적인생각입니다. 암튼 난 꿀잼ㅋㅋ	연기력
최고의 연기력과 기획 이영애 최고~!	연기력
로버트드니로의 소름끼치는 연기력이 압권이었음	연기력
김지영(인호엄마)님의 연기력 캬!	연기력
이 영화는 모든 중, 고등학교에서 국사 시간에 의무적으로 꼭 봐야 하는 영화입니다 6.25의 비극적이고 참혹함을 이보다 더 잘 표현한 영화는 없습니다 고수를 비롯한 배우들의 미친 연기력도 볼 만 합니다	연기력
연출,편집,연기력,반전......모든게 완벽하다 프리즌브레이크 본후로 미드에 빠짐	연기력
연기력 솔직히 최고아냐? 글고 문근영 이뽀...	연기력
스토리, 분위기, 연기력 여태껏 봐 왔던 영화중에 개인적으로 최악중에 꼽히는 영화.단, 최민수 형님 연기력은 제외.. 형 본것만으로도 만족합니다;	연기력
빈센트의 그 외롭고 갸냘픈 시선 연기력만 볼만한 영화	연기력
꼭 생각해 봐야 할 점을 건조하고 현실적이게 잘 담아냈다. 연기력도 좋고.	연기력
추천에 추천을 걸쳐 보았던 드라마이다.드라마나 영화를 보고 내가 운경우는 극히 드물었다 그런데 이 드라마는 뭔가 뭉클 하는게 있었고 또 작품성 또한 좋았고 배우들의 연기력도 좋았고 인기의 한목했다고 생각한다	연기력
영화의 몰입도를 넘어서는 소설을 그대로 옮겨 놓은듯한 연출력과 연기력...훌륭하다.	연기력
형편없는 대본+연기력+편집 = 뚝뚝끊어지는 이야기 흐름.. 대책없다. 박창진 감독 이름석자 꼭 기억하마!	연기력
신인작가가 쓴 단막극장 정도 스토리에 배우들은 다 하급이고 연기력도 하류	연기력
와...스토리 연기력 진짜 쩐다...이것이 영화지	연기력
재밌게 봤습니다송강호씨 연기력이 인상 깊네요	연기력
스토리 쓰레기, 연기력 쓰레기, 브루스 10분 나오고..보면서 짜증 제대로	연기력
나중에서야 보게 된 영화.. 안봤으면 어쩔 뻔 했는지 ..정말재미있고 리암니슨의 연기력은 최고였다	연기력
에르몬넬라 야호의 연기력이 돋보였던 오페라. 몰입이 너무 잘됐어요.	연기력
정말 질 떨어지네요. 특히 연기력은 완전 아마추어 수준이네요. 반성하세요 제작진들	연기력
영화가 왜 망한줄 알겠다...취지는 좋았으나 남자주연의 연기력보다 답답한전개가 보는사람을 짜증나게한다.	연기력
1점도 아깝다. 감독 뭘 배우고 영화를 찍은건지. 영화인으로써 참 부끄럽다. 연기력은 보고 캐스트 한건지 참. 뭐 트리트먼트 가져다 영화 찍어도 이것보단 잘나오겠네. 1학년 중간고사 작품만도 못나온거 같은데 제작비가 아깝다. 찍지마. 차라리 술마셔.	연기력
황우슬혜는 연기력이 뛰어난 훈녀다.	연기력
연기력은 UFO를 타고 저 멀리...	연기력
뻔하디 뻔한 3류 액션 첩보물. 배우들의 연기력은 너무나도 어색해서 보는 내가 다 민망해지고 거기에 한방씩 맞아주며 쓰러지는 악당들에게 한심함마저 느껴질 정도... 칭찬을 하려해도 할 곳이 없는, 어떤 의미론 정말 굉장한 영화	연기력
와 ㅎㅎ 넘재밌다 ㅎㅎ 우리나라영화는 잘 안보는데,...... 우리나라 로맨틱코미디중에 최고인듯 ㅋㅋㅋㅋ송중기넘 귀엽다 ㅎㅎ 한예슬두이쁘구, 두배우의 연기력이 영화를 더 빛낸듯!	연기력
전혀 기대안하고 봄. 드라마 안보는사람으로서 인터넷에 변요한 가끔뜨길래 얼굴빨로 일개 드라마나 출연하는 전형적인 미남배우인줄 알았는데 이거보고 연기력 인정함; 스토리도 부조리한 사회풍자에 스릴러까지 매우 좋았고 무엇보다 출연배우들 연기력이 지렸던 영화	연기력
진짜 연기력들 죽이네.. 대사도 여러번 보게 될 거 같다..	연기력
이완...연기력에 박수....파생거래를 아는 사람이 봐야만 같이 긴장할수 있는 영화...모르고 본다면 정말 지루할수도..	연기력
179분이라는 엄청난 러닝타임 이지만 전혀 지루하지가 않다.그리고 디카프리오의 미치 연기력.	연기력
사실스토리가아이리스일에비핸덜탄탄하고 빈약하지만배우들의 그소름끼칠정도의 연기력 너무멋지고감동입니다..한가지 왜비극일까요.장혁이어쩔수없는상황도아니였고 왜죽게끔..ㅜ가슴이너무아프네요 눈물이쉴새없이ㅠ배우분들제작진분들정말수고많으셨어요너무재밋엇습니다♥	연기력
연기력, 영상미 굿.	연기력
안성기의 아역 연기력, 허장강의 어설픈 외국어실력을 볼 수 있었던 영화.	연기력
애슐리 주드 연기력은 좋다만, 블론드가 끌리는건 어쩔수없내	연기력
연기력 하나만으로도 먹어준다.	연기력
드라마 내용과 구성은 정말 괜찮으나 주연 배우들의 연기력이 많이 아쉬웟던 드라마.. 특히 지현우씨의 어색한 사극톤은 16회까지 봐도 적응이 되지를 않는다...	연기력
최고의 연기력들~~~	연기력
희래엄마 연기력 진짜 어의없음 몰입이안됨	연기력
감독이 전하는 메시지는 좋았으나... 주인공 남, 여 빼고 외 남자 3명이 받쳐줘야하는 부분에서 연기력이나 행동들이 너무 성의없이 보였다.. 1인4역보다 1인 다역을 하는게 평점은 더 좋지 않았을까? 평점은 남여각각 3점 감독3점 남자3명 -2점	연기력
장르가 왜 코미디일까. 김수로 연기력 폭발!	연기력
완성도 높은 스토리 반전.. 높은 연기력에 집중이 잘되었다	연기력
8점을 하고싶으나 평점이 좀 낮아서... 9점 클릭 했어요 그리고 영화가 전하고자하는 메시지가 상당히 많고 좋았습니다. 예지원씨 연기력도 굳!	연기력
그의 연기력에 감탄했어요	연기력
에릭로버츠와 존보이트의 연기력이 정말 일품. 엔딩장면은 정말 최고다.	연기력
재미가 없다기 보단 남는 게 없다. 영국분들 연기력들은 당연 좋았지만. 내용이 별로.	연기력
아주 예전에 본,, 오지호 최악의 연기력만 기억에 남아있음	연기력
지루하고 질질끄는 스토리에 극적인장면은 하나도안나오고 주인공 연기력만 믿고보는	연기력
드니로의 좋은 연기력 옛날 영화이지만 지금봐도 꿀 잼.	연기력
이 영화가 2010년에 만들어졌다는게 가장 큰 충격입니다. 연기력 별로고 그래픽도 진짜 구립니다. 유치해서 웃음이 나올지경입니다. 스토리는 뭐 재난영화 비슷하고....	연기력
연출력과 연기력, 모두 역부족.. 답답한 로케이션. 야인시대외전?	연기력
각자의 연기력으로 빠져들게 했던 영화이다.감상후 온몸이 무겁고 무기력해졌던 영화.내주위에 또는 여러사람주변에서 일어날수있음직한 내용들로 가득하다.과장은 절대 찾아볼수없는...그래서 더욱 마음이 무겁기만하다.근래들어 잘 만들어진 작품이라 말할수 있겠다.	연기력
그저그런 소재에 , 어찌보면 밋밋할정도의 기승전결을 배우의 연기력과 제목이 캐리했다.	연기력
김래원 엄정화 연기력 좋고좋고	연기력
여주 연기력이.... 내용은 할 말이 없네요	연기력
내 인생 최고(?)또는,최악(?)의 드라마.막장도 갑...반전도 썰렁한 걸로,갑...장미희의 쓸데없는 연기력만 눈부시게 빛나네.똑 사세요~똑.이용.이장우랑,오연서는,사귀는지 ,안 사귀는지,관심도 없는데도,지들 끼리 오도 방정,호들갑 다떨고 다님(웃음)	연기력
서우 연기력이 무섭다	연기력
"""썅!! 젠장 처음 20분 보다 연기력에 좌절하고 마지막 장면이 대박이라해서 스킵해서 봤더니 틱장애라는말에 공감을 """"나만당할수 없지"""" 라는 생각에 마지막보라고 한평점들이었다니 ㄷㄷ"""	연기력
평점이 딱 6점수준..연기력10. 연출력 1. 스토리구성 0 범행의 동기부여 노이해	연기력
여주인공의 연기력이 너무 좋다.. 스토리도 어슬프지않고 짜임새있고.. 이런류의 영화를 좋아하지않아 중간중간 지루함도 있었지만 그 지루함이 오래가질않게끔하는 매력이 있는 영화...	연기력
영화라는 매체상 시간제한이 있는데 상영시간내에 원작의 내용과 느낌을 잘표현하였다.인물들의 연기력도 영화를 몰입하기에 충분하였다.	연기력
이정도면 충분히 재미를 준 훌륭한 오락영화였다. 연기력들도 탄탄	연기력
오~ 정말 별 기대안하고 봤는데... 소재와 연기력 연출 삼박자가 만들어낸 최고의 공포 스릴러 무비 !!! 다음 장면을 예상함에도 움찔움찔!!	연기력
흠... 영화로 보면 실망할 것 같더니... 실망이 컸습니다... 연기력들이...ㅠㅠ	연기력
연기력 ㅋ 여러분들 연기력 연기력 잘보세요^^	연기력
사극은 연기력이 출중한 배우를 주연으로 써야 하는거 아닌가?	연기력
진짜1점도주기싫은드라마.송혜교 조인성걍시청률올릴라고퍼부은드라마.연기력땅을친다진짜.특히조인성 눈크게울면연기잘한다생각하나.토나온다아이리스와같이본드라마.장혁 조인성연기력차이너무난다.막장대본참성공률한자릿수수술성공하지안나ㅋ칼맞고살지안나그나마볼건정은지의연기력발견	연기력
이런 영화에 평점이라니...연기력 최악...스토리 최악...TV드라마인줄 알았다..	연기력
브루스 윌리스의 연기력은 끝이없도다	연기력
너무 개 쓰레기 같은 영화 애미없는 구성 진부한 스토리 토 나오는 연기력 삼위일체	연기력
보면서 육성으로 욕나오는 영화…집착도 병이다…저건 순수가 아니라 무뇌야…그만큼 조보아가 연기를 잘한 거니까, 조보아 연기력에 4점 드림.	연기력
많이 무섭지는 않은데 긴장감은 최고ㅋ후반부에 반전과 특히 어린나이인데도 주인공의 소름 돋는 연기력은 ㄷㄷ.	연기력
우와 이런영화도있구나 연기력0.1 스토리0.2 음악ㅇ 합이 0.3 진짜 발연기는그렇다치고 중간중간나오는 60년대 통기타소리는 정말이지 최악이다	연기력
내가 봤던 영화중에 가장 웃기지 않았던 영화다. 억지웃음 짜내는 장면 많고 웃음포인트가 너무나 단순해서 다 보인다. 배우들 연기력도 너무 별로였다.. 10년이나 지나서 그런지는 몰라도 노잼 그 자체였음.	연기력
이때까지본조선사극중제일역사와비슷하게만들었더군요그래서더재밌었어요연기자들한분한분연기력이얼마나뛰어나던지김현주씨연기력이정말말이안나올정도로굿!처음부터얌전의편이여서그런지마지막에얼마나안타깝던지ㅠ태어날때부터무시받고살다궁궐에입궐해서도무시받으니저같았어도독기품었을꺼에요	연기력
처음에 무슨 옛날 영화냐고 했는데 역시 예전이나 지금이나 톰행크스는 연기력의 끝이다	연기력
안소희 인생에 첫작품이자 마지막작품ㅋㅋㅋㅋㅋㅋㅋ비쥬얼,연기력,발성 모두 최악	연기력
연기력 별5개 감동 별 4개 전해지는내용 별 4개 개인적인 영화평가 별1개	연기력
오늘 똥개를 보았습니다. 줄거리 잔혀 모르고 봤더니 확실히 영화가 재밌습니다. 정우성을 비롯하여 출연배우들의 연기력에 감탄하면 즐겁게 잘 봤습니다. 한국영화 점점 대단해져서 무척 좋습니다.	연기력
아 연기력 오글거려 두번은 못보겠다	연기력
지금 나의 현실과 공감하는 부분이 많아 몰입하면서 봤네요.배우들에 연기력 신임감독에 노련한 연출이 엿보이는 작품이네요 저예산 영화지만 박수를 쳐주고 싶은 영화인거 같아요.	연기력
....주인공의 연기력빼곤 볼게 없던영화	연기력
케빈 형님...재능은 정말 뛰어난데 그 뛰어난 재능을 이런 영화에 썩히다니...케빈 스페이시가 그 뛰어난 연기력과 카리스마에 비해 필모그래피를 보면 출연편수에 비해 명작이 많지 않다. 제발 다시는 이런 영화 나오지 마소서	연기력
중국에서 안병기의 이름을 알린 출세작. 성공에 힘입어 3편까지 제작. 매정 이라는 배우의 외모와 연기력이 수준급이지만 익숙하다못해 진부한 모티브들과 무섭지 않다는게 단점	연기력
내가 본 한국 드라마사상 최고의 수작. 작가의 필력, 감독의 연출력, 음악감독의 배경음악, 카메라워크, 배우들의 빼어난 연기력...모두 10점 만점에 10점. 최고.	연기력
구구절절 설명하고 이해시키려는 노력이 큰 의미없이 다가온다. 차라리 이유없는 사이코패스를 그려내는 쪽이 나았을듯. 괜찮은 아이디어와 흥미로운 장면들이 꽤나 있지만 팀장의 연기력이 끊임없이 맥을 끊는다.	연기력
연기력도 좋고 친구들간의 우애,의리넘치는 영화네요 하 너무 울었다 ㅠㅠㅠㅠ	연기력
세계 유일 분단 국가. 인간은 역시 잔인한 동물. 누굴 욕할 거 없이 나도 마찬가지. 근디 현재 연기력 인정 받는 배우들도 이 때는 발연기였네유.	연기력
멍청한 시나리오, 작위적이고 오그라드는 캐릭터 그리고 연기력. 한국영화 OO라!	연기력
수목장이라는 영화를 보고 봐서 그런지 너무나 후한 점수를 주게되네요.모 그래도 공포영화의 요소는 어느정도 집어 넣었고, 재밌었네요.그런데 화면구성이나 장소 연기력등등 너무 미흡한점은 많았어요. 볼 영화 없으면 한번쯤 봐도 될듯?	연기력
송혜교는 걍 하늘이 주신 천사임 진심 드라마보는내내 비주얼쇼크 ㄷㄷ 연기력도 소름돋게했다 어떻게 대한민국에 그런 여배우가	연기력
박보영의 기가막힌 연기력클라스를 볼수잇는영화;; 이것만 여섯번봄.. 개명작..	연기력
이런 명작 서부영화는 앞으로도 절대 나오지 못할것이다.세명의 생생한 케릭터,연기력,스토리전개,거기에 위트까지. 마지막 결투씬과 결말은 정말 너무나 멋진 명장면이 아닐수 없고 마무리다.	연기력
새끼곰 수컷곰한테 아카데미 상하나 줘야된다. 연기력쩐다.	연기력
차승원 송윤아 연기력 조조연급임.한국영화는 조폭 안들어가면 영화를 못만드나봉가	연기력
연기력이 안되니까 벗는 구나. 연기력 딸리는 여배우들의 흔한 선택.	연기력
일베충들 단체로 김보성 영화 10점 주는꼴보소..ㅋㅋ 케이블서 지금보는데... 이건머 스토리 병맛에 연기력은 후지산 대폭발해버릴듯.	연기력
시청자 조차 몰입하게되는 스토리 .눈을 사로잡는 배우들의 연기력 .귀를 귀울이게 하는 대사 .한회한회 볼때마다 생각하게 하는 이 드라마. 많은것을 얻었습니다.황금의제국 관계자분들 감사드립니다.	연기력
뛰어난 연기력과 연출 그리고 시나리오	연기력
이 명작이 왜 7점밖에 안될까요? 평점만 보고 안보려고 했다가 안봤다면 후회할 뻔한 영화였네요..짜임새 스케일 연기력 대만족합니다..	연기력
솔직히 영화를 끌어가는데 지루함이 좀 있지만 전하고자 하는 의미와 여운이 큰 영화이다. 요즘 나오는 상업영화는 결코 따라오지 못할 힘이 있다. 이병헌은 영화에서도 이루어지지못하는 일을 현실로만든, 그때도 역시 연기력이 대단했던 배우다	연기력
주연배우들의 연기력이 참 좋네요~김정학 연기력 최고~~!!	연기력
정말 더빙 때문에 좋은 영화 망쳤네요..엄마 목소리는 정말 듣기 싫네요..연기력이 없어 감동은 못 받네요..	연기력
덴젤워싱턴의 절제된...그러나...알수없는 포스를 느낄수있는 연기력....	연기력
시간 가는줄 모르고 봄 작가가 뭘좀 아넹 글고 연기력들이 다 ㄷㄷ함	연기력
김태희의 연기력이 바닥이다	연기력
재밌네용~~ 야하기만하고 내용은별거없는허접한영화도많은데 내용도탄탄하고 몰입해서잘봤어요 다른부분도다훌륭하지만 연기력 음악 영상미 굿굿	연기력
연기력최고 몰입도최고	연기력
시공간을 뛰어넘는 한 남자의 3가지 사랑이야기! 예쁘고, 웃기고, 멋있고, 아름답고.. 21세기에 오랜만에 모든 것을 다 갖춘 천재적인 감독의 등장!! 배우 야마다 다카유키 연기력이 정점에 이르다. 감각적이고, 스타일리쉬한 보기드문 영화!	연기력
펜레터를 꺼내려다 죽은 미키 이야기에 눈물이 쏟아진 건 내가 OOO라서인가? 3류 코메디처럼 끝나는 엔딩에서는 울어야 할지 웃어야 할 지 난감했다. 각본이 워낙 좋으면 연출이나 연기력 따윈 별로 중요하지 않다는 걸 보여준 영화...	연기력
연기력 뛰어나 몰입이 잘되는군요 중간에 약간 루즈한거만빼면 괜찮을듣	연기력
이홍기 진짜 미스캐스팅이구만 연기력있는 배우들을 쓰란 말이다!	연기력
지루하고 뻔한반전 무엇보다 연기력 ㅆㅎㅌㅊ	연기력
정말 쓰레기 영화가 따로 없다. 중간 중간 끊어지는 화면 흐름. 허접한 배우 연기력..도대체 뭘 말할려고 하는 영화인지 모르겠고 이제 짱꼴라 영화는 더이상 안볼란다. 더는 안속아~	연기력
할리우드의 큰별이졌네요... 이영화 다소 지루할수있습니다. 러닝타임도 길고요. 그러나 벌써 6년이나 지났음에도 잊혀지지않는 호프만의 섬뜩한 눈빛. 그의 연기력만으로도 충분히 가치있는작품입니다. 창작의 고통과 인간의 이기심도 잘 표현했구요.	연기력
생각할게 많은 영화. 연기력이 좋아 지루하지 않게 몰입 가능	연기력
1원을 보고 찾아서 이 영화를 보게 됨! 난 솔직히 이게 훨씬 전쟁 씬 장면이라던지 주인공들의 연기력이 더 뛰어나 몰입감 짱이었던 영화!	연기력
강진주(윤해영)와 서지환(이재황) 주연배우 및 화려한 조연배우들의 캐스팅과 뛰어난 연기력 그리고, 흥미진진한 스토리전개로 100%로 몰입하여며 재미있게 시청하고 있습니다. 힘든과정에서 열심히 촬영하는 제작진과 배우들 더욱더 힘내서 화이팅 하세요!	연기력
진심 졸작입니다. 배우진도 김영애씨 제외하곤 ㅈ망 캐스팅입니다. 특히 송일국씨는 슈퍼맨이나 찍으시기 바랍니다. 어쩜 연기력이 10년전이나 지금이나 변함이 없는지....ㅉㅉㅉ 스토리라인도 지루하기 그지없습니다. 보지마세요.	연기력
미친 연기력 진짜 웃기다 ㅋㅋㅋ게이에 대한 거부감있는 분은 피하시길	연기력
미안하지만 초반흑인배우의 극악의 연기력을 보고 바로껏습니다 시걸형님ㅈㅅ	연기력
엉성한 구성에 형편없는 연기력.중견 배우도 연기력 참고해서 등장 시켰으면...	연기력
살리에르의 질투심에 깊이 공감했다. 연기력과 연출이 시대를 초월하는 영화	연기력
여기에10점준사람들은뭐지;;;;내용도뻔하지만 성형미인주리에연기력은 정말 발연기에갑..;;깜짝놀랐다 그런연기에 주연이라니...;;;;	연기력
스토리 개연성도 부족하고..무엇보다 배우들 연기력에 깜짝놀람. 이동욱은 이렇게 잘못했었나 하고. 송지효는 어쩜 늘지를 않을까. 어린아이는 아이고 귀엽다. 차라리 아빠어디가를 보는걸 추천	연기력
문성근 아저씨 연기력땜에 1점 나머지 감독이 말하고자하는바는 가히 쓰레기수준이네요	연기력
아, 보는 내내 정말 빵빵 터집니다! ㅋㅋㅋㅋㅋ 연기자분들 연기력도 좋고, 스토리도 괜찮네요~^^	연기력
보는내내 긴장하게 하는영화배우들 연기력도 좋고무거운소재를 재미있게 잘 풀어낸듯	연기력
정말 매회마다 스릴넘치고 다음회를 기대하게 만들어요. 배우분들 연기력도 최고에요	연기력
역시 연기력 최고!깨알같은 웃음 유발 요소가 있네요!조연 주연 모두 빛나능 영화입니다. 고래까지두요!	연기력
환상적인 cG 환상적인 연기력... 몸서리치게 만드는 ... 꼭보세요들 .. 안보기만해ㅠ	연기력
칼같을것 같은 사람이 의외로 허당일때 느끼는 묘한 친근감이 가득 배어난다. 분위기,음악,연기력,대사 명품 4중주.	연기력
스토리 너무 엉성하고 연기력은 뭐 빅뱅 뮤직비디오 찍은건지 원 영화로 나온건이 놀라올 따름이다	연기력
진짜 보면서 펑펑 울었던, 모든 배우들의 연기력이 돋보였던 드라마였죠.	연기력
회장손녀 정아 발바닥연기력,,연습좀해줬음하네요정말,어설퍼서채널돌리게되는,,,서우는오글거리는눈알만오르락내리락. 볼때마다느끼하고,,강서연이그남아연기젤낮네요. 얼굴볼때마다짜증나는거보면. 복수는언제할련지그만좀끌어요~~	연기력
장혁완전..연기력작력이다;진짜보고 마지막에눈물낫다..그리고인간적으로 까대는쓰.레기들아;니내가 직접각본쓰고 해바라; 솔직히 아이돌도그렇고 이정도연기력이면훌륭해 그리고 니내는첩보액션드라마에서 주연이 총을맞겟냐?가끔맞을수도있지만 드라만데 다큐도아니고;	연기력
Tv에서 방영되서 잠깐보려다 눈못때고 끝까지보게됬네요 연기력도 너무좋고,,독립영화는 처음이었는데,,선입견을버리게됬네요~^^	연기력
아직 나의 능력이 여기까지 오진 못한 것 같다. 뭔가 쉬운 얘기같으면서도 굉장히 어려운 영화라고 할까? 너무 지루해서 마지막 30분은 빨리 돌리면서 봤다. 하지만 호아킨의 연기력은 엄청나다.	연기력
신선한 소재와 호흡의 연출, 배우들의 연기력... 잠이 확 깼음!	연기력
연기력짱 완전 연기를 잘해요	연기력
아이 키우는 부모로서는 정말 충분히 이유가 있는 살인일듯엄정화의 대단한 연기력에 정말 놀랐다...	연기력
제목이 많이 아쉽네요.. 기대이상 재미있게 봤습니다. 간만에 감독을 찾아볼정도로 느낌있네요.. 연기력들도 전반적으로 좋습니다!!	연기력
Com-아끼고 아껴보던.. 정말.. 명작.. 주옥같은 그 당시 노래와.. 소품들.. 그리고.. 기대치 않았던.. 신인배우들의 연기력... 깨알같던.. 까메오 출연과.. 실타래 풀리는 듯한 스토리가.. 회를 거듭할수록 기대하게 하는 명작 드라마	연기력
개봉 4일만에 DVDRIP 뜬것만 봐도 별로라는걸 알 수 있다. 영화관에서 무료로 보여준다고 해도 솔직히 왕복 시간이랑 기름값 아까웠을듯;;진심 궁금한건데 남자 형사분 감독님 지인이신지? 연기력 오지네요!! 남자 형사님 연기 보는 재미 빼고는 볼거X	연기력
역시 맥어보이 연기는... 믿고보는 연기, 영화내용을 더 살리는게 맥어보이의 연기력같다	연기력
반전쥑이는 수작!!배우들의 탄탄한 연기력과 탄탄한 스토리!쥑이는 반전이 정말 재밌는 스릴러 영화에요.	연기력
시청률로 평가하기엔 너무나 멋진 드라마.한편의 영화를 보는 듯한 영상미와 배우들의 초절정 연기력 모든 것이 완벽했다.진정 시청자로서는 행복한 시간들 이였다. 아시겠습니까?	연기력
대박이지 이건 연기력 캐리	연기력
스토리도, 연출도, 연기력도 죄다 영... 그나마 액션을 기대하고 봤는데 그마저도 여주가 상당한 비중을 차지해버리고 무엇보다 가장 큰 문제는 견자단마저 제대로 된 액션을 못보여준다는점 으으...	연기력
액션도 너무 작위적 억지스럽고 클레멘타인이 연상되는 삼류 영화임 배우들의 연기력이 아깝다	연기력
CG도 최악 스토리도 최악 연기력도 최악...긴장감이 조금있는듯 하지만... 전체적으로너무 재미없는.영화	연기력
성동일,김희원씨는 연기력은 탑급인데 쓰레기영화도 마다하지않는 이상한사람들이고..김강우는ㅋㅋ집에 돈없나 진짜 이해가안가는 배우	연기력
연기력이 너무 좋아 상황이 더욱 역겨웠습니다	연기력
극강의 연출력과 연기력. 이것이 바로 벤 애플렉이 만든 보스턴의 전설이다.	연기력
신하균씨 연기력에 푹 빠지네요.	연기력
레오의 연기력은 실제가 아닌가 싶을 정도로 무섭다	연기력
전문성우 데려다 써야죠..안그래도 브라운관에 연기력 떨어지는 아이돌들이 연기한답시고 설치는꼴 보기 벅찬데 목소리까지...어휴	연기력
흥행안된게이해불가..다소어려운부분이있으나 그래도 몰입도가 쩔어요..진짜완전집중해서봄ㅠㅠ 남주 연기력쩔어요	연기력
화이어 버드? 웃음이 폭발하는 연기자들의 연기력	연기력
연기력, 연출, 스토리 무엇하나 제대로 된게 없는, 중간에 잠든 공포영화	연기력
정말 재미없습니다. 이 좋은 시나리오 가지고, 배우들 연기력도 어울리지 않고. 영화보는내내 전개와 상황이 지루해서 몰입도 안됬습니다. 감독의 연출실패라고 보여집니다. 원작을 기대하며 봤는데, 남는것은 내가 이걸 왜봤지라는 분노의 마음뿐.	연기력
배우분들의 연기력도 뛰어나고 몰입감이 죽이내요 ㅎㅎ	연기력
배우들 연기력이 굉장하네요 .. 담백하고 다소 차갑지만 사람을 끌어안는 시선을 가진 영화인듯	연기력
연기력이 있을거란 착각속에 베드신도 어색, 로맨스도 어색, 무엇보다 우정출현들의 등장은 헐~~~	연기력
연기력 좋은 주연배우들의 위력을 실감하게 하는 영화	연기력
발로 쓴 대본, 오그라드는 연기력 2012년 최악의 드라마	연기력
남자 여자 주인공 둘다 너무 좋고 잘어울려서 드라마 몰입도 잘 되는 듯!!구혜선엉니 연기력많이 늘은듯! 조으다	연기력
진짜 의뢰인하고 비교했을때 왜이렇게 긴장감이 떨어지고 재미가 없냐... 연기력에 대한 말이 많은데 진짜 일반인이 봐도 연기력 진짜 어색하고 못하네... 특히 판사랑 변호사....	연기력
전혀 지루하지 않았고 좋은 연기력과 잊혀질 뻔한 인물을 재조명 한거에 놀라움이 따른다	연기력
감독과 김창완이 말아먹은 영화...간호사들 연기력 땜에 최악은 면했음..	연기력
연기력 스토리 그냥 보통임	연기력
영화의 몰입도는 좋았지만 재미는 부족했다. 그러나 주인공의 연기력이 바꿔놓았다	연기력
식상한 소재가 그나마 먹히려면 이중반전이나 비주얼 배우들이 아니라, 연기력과 보다 촘촘한 전개가 필요했다	연기력
이정현의 연기력은 정말 엄청나다.... 이 어린 나이때부터 이정현의 연기력은 신적인 수준이었다... 정말 엄청나단 감탄밖에는...... 이정현... 진짜 대단한 사람.... 못하는게 없다... 가수, MC, CF, 라디오, 드라마, 영화...	연기력
포레스트 휘태커의 연기력에 지리는 영화.	연기력
정말 실망스럽기 그지없다.감동도 연기력도 구성도 다 쓰레기	연기력
신소율은 연기력이나 외모에 비해 작품을 너무 못고르는 것 같다.	연기력
정재영의 연기력+남지현의 깜직함.. 볼만하던데~	연기력
근래 본 영호중 가장 어이없었음. 이게뭐야?만 연발하다 영화가 끝남.신하균 연기력으로 만 살린 영화다. 시나리오나 연출이나 이래도 됨? 이게 반전이라니... 배우가 정말 아깝다.	연기력
후.... 두 주연배우 연기력만 점수 주고싶다	연기력
분위기는 좋았지만 뜬금없는 전개와 난잡한 구성으로 영화를 보는 내내 자리에서 일어나고 싶었다. 1점이 아닌 3점을 준 이유는 분위기+ 몇몇 배우들의 연기력 때문이다.	연기력
연기력, 스토리, 감동 세박자의 완성70년대 유신정권에 대한 시대상의 반영과현대적 '아버지'의 단면을 잘 조화시킨 작품	연기력
누구한명의 연기력때문에 이제 그만봅니다..어색 오글거림	연기력
보고나서 시간이 아까웠던 몇 안되는 영화 중 하나.너무 뻔한 스토리에다 배우들의 연기다 뭐다 따질 수 없을 만큼 그 누구의 연기력도 돋보이지 않았으며, 배우들이 아까웠다.	연기력
앞엔 재밌었다 뒤에는 감동적이었다 끝.. 마지막의 전개가 너무 빨랐고 급마무리가 아쉬웠음 주제는 뭘까.. 하정우 연기력엔 좀 감동	연기력
하정우 연기력이 일품.	연기력
현실성이 너무 떨어지네요. 만화책이랑 액션이 다를게 없음. 연기력도 실망스럽고.,. 내용의 짜임새도 허술하고,, 8점 가까이되는 평점이 의아하네요	연기력
연기력은 한예리와 동급(영어는 강점),.. 작업복은 글쎄요	연기력
각본은 둘째치고.연기력들이.김혜선씨사극때논란 된적도있지만,연기력이왜그런지.남주나역두말하면입아프고!전개 도붙이고,화끈한복수로통쾌한 마무리 해주세요(그리고 모든 역할들의 만남 장소인 카페는 맨날 똑같아요 심지어 테이블 위치도ㅋ 아무리 아침 드라마라지만)	연기력
남자주인공의 연기력과90년대부터 현재까지 시대적 배경 연출및공감가는 현실적인 대사들, 다시한번웃고울고갑니다~개봉관이 많지않아 아쉽네요	연기력
허접한 스토리. 허접한 연기력.	연기력
진짜 재밌고 연기력도 전부 최고	연기력
독립영화도 좋고 저예산 영화도 좋다... 근데 말이다....제발 시나리오 좀 제대로 만들고,,, 배우들도 연기력좀 보고 캐스팅해라...이 영화가 내세울게 뭐냐???	연기력
이렇게 슬픈 영화는 처음이에요.. 몇년만에 다시 봤는데도 펑펑 눈물, 콧물이 나오네요.. 연기력도 좋고.. 스토리도 좋고.. 가장 좋았던건 대사가 너무 좋았어요..^^	연기력
유치해서 빛을발한영화,,마이어스의 연기력이 볼만하다~	연기력
김명민 연기력 짱bb 남을 위해 달리던 주만호가 완주한 장면이 정말 명장면bb	연기력
어찌보면 새로울것 없는 내용의 멜로 이야기를 두 배우의 탁월한 연기력으로 몰입하게 만들었다.	연기력
채림은 너무 이쁜 외모에 멋진 연기력이 돋보이는 국민여배우다.	연기력
연기력두 좋은거같아요	연기력
"""스토리, 연출, 연기, 비주얼 등 영화의 기본 조차 안된 영화에 무슨 평을 해. 이런 영화 찍고도 김문옥 감독은 """"내가 영화 경력이 몇OO인데 조무래기들이 내 영화를 평론해?"""" 같은 마인드에 빠져있겠지?"""	스토리/구성
미친놈들 집합소네 연출력 빵점, 스토리 빵점. 구성빵점	스토리/구성
신선한 소재로 식상한 영화를 만들었어..유치한건 둘째치고 재밋게라도 만들던가..	스토리/구성
데어데블보다 못한 졸작. CG는 훌륭하지만 악마 인형탈쓰고 나오는게 웃기고 인물 관계나 스토리가 너무 뻔함. 시간이 아까움. 짧은 러닝타임이 고마울 정도.	스토리/구성
차인표 연기는 너무 현실적이여서 마음에 와닿는다 왕초드라마를볼때도 난 연기를하는건지 진짜 실제로 그러는건지 몰랐다 이영화 내용이 쥐어짜는스토리지만 차인표라는 배우때문에 영화가살았다 너무 현실적인 연기력이다 대단하다 눈물한방울 흘리지않았지만 마음이아팠다	스토리/구성
스토리가 신선하다. 재미있다. 좋다.	스토리/구성
다시 봐도 수작이다. 미국 국수주의라 뭐라는 시점도 있겠으나 전쟁물 중에 손가락안에 꼽을정도로 잘만들어 졌다. 스토리 라인은 뻔하나 그 뻔한걸 너무 잘 살렸다. 언제 봐도 다시봐도 재미 있다. 10년이 지난 영화가..	스토리/구성
클럽과 사건의 연결이 전혀안된다. 섹스클럽얘기는 흥미거리일뿐 스토리연관이 없다.	스토리/구성
전작에 비해 훨씬 스토리도 고급스러웠고, 무엇보다 이번편에서도 역시 간지나는 액션신은 스타뎀 성님이 도맡아 하시는거보고 더욱 좋았다.	스토리/구성
왜 이렇게 다들 스토리에 불만이지....... 이야기에는 다 원형이 있다. 이 영화는 그 원형이 되는 스토리 안에서 예술을 한거고... 그걸 가지고 진부하다고 하면 대체 뭘 본건지..	스토리/구성
-,.ㅡ 허접스런 영화,스토리도 시대착오적인..3류 코미디	스토리/구성
정신없는 여자주인공보느라고 어지럽다. 스토리도 완전 어거지;;	스토리/구성
뭔가 스토리가 이상함	스토리/구성
정말 초딩을 위해서 만든거 스토리 쓰레기 벨런스쓰레기 액션쓰레기	스토리/구성
졸다니...ㅠ그냥생물들소개..스토리無 3d어지럽고 나레이션오글오글..ㅋㅋㅋ애기영화	스토리/구성
몰입도 제로 뱀파이어가 피 조금 흘려서 자살하는 꼴에 늑대인간과 뱀파이어라는 초자연적인 존재의 총격전은 왜 하필 소재가 늑대인간대 뱀파이어인지도 모르겠는 작품	스토리/구성
스토리. 캐릭터. 표현력. 영상미.	스토리/구성
스토리도 정말 별거없구 엄청 지루함.	스토리/구성
뻔한 스토리, 조잡한 효과...	스토리/구성
참신한 소재지만 어슬픈 마무리때문에 실화인줄 알았네	스토리/구성
줄거리만 읽어도 대충 감이오는 스토리와 결말이라 기대안하고 봤는데 역시 예상대로였지만 재밌게봤다훈훈해서 좋달까~~	스토리/구성
훈훈한 내용이지만 스토리가 다소 억지스럽고 부족하다.	스토리/구성
캡틴 듀브아 나올 때마다 너무 웃겼다. 줄리안이랑 곰의 러브스토리도 재밌었고 무엇보다 서커스씬은 노래 firework와 어울려 환상적이었다.	스토리/구성
좋은 스릴러 소재로 왜 엉성한 멜로를 만들었을까?	스토리/구성
권선징악이라는 진부한 스토리..하지만 드라마 중반부까진 10점 주어도 괜찮을듯한 연출 스토리 연기력. 후반부 갈수록 누구나 예상가능한 권선징악결론이겠지만 왜인지..예상못할 훌륭한 반전 하나정도 나오지 않을까하는 개인적인생각입니다. 암튼 난 꿀잼ㅋㅋ	스토리/구성
스토리가 스릴있고 훈훈하다	스토리/구성
좋은 소재지만 연출이 ㅈ망이네	스토리/구성
티비에서 방영해주길래 우연히 보게 됐습니다.평점이 왜 8점밖에 되지 않나 의문이네요 스토리가 진행되며 느껴지는 쾌락, 슬픔 그리고 사회 풍자적 요소 정말 재밌게 봤습니다..	스토리/구성
평점이 왜이렇게 낮은걸까요?; 소재도 신선하고 중간중간 많이 웃었습니다 ㅋㅋ	스토리/구성
1편 수준을 기대하고 봤는데, 스토리도 난잡하고 재미가 없는게 결정적.. 다음편은 안볼듯	스토리/구성
빈약한 스토리 빈약한 각본 빈약한 연출 빈약한 그래픽 보고나면 정신도 빈약...	스토리/구성
주인공도 매력적이지 않고, 스토리도 어디서 많이 본듯하다	스토리/구성
정말 어지간히 좀 하기를 ... 자중나서 점점 보기 시러진다 .. 다른 방송사 드라마보다 정말 스토리 전개가 뻔하다 .... 무슨 미리예상한데로 보는 드라마인지 ...	스토리/구성
별점 반개도 아깝네요. 내용도 없고 약간 중간에서 갈팡질팡해야하는 그런 스릴이 있어야하는데 저스틴 연기가 아직 부족한듯. 각본, 연기, 연출력 다 망한 영화.	스토리/구성
완전 내 스타일... 아 샤를리즈 테론 아직도 여신급으로 아름답고 스토리도 아주 꿀잼입니다. 왜이리 평가가 낮죠 ㅎㅎㅎㅎ	스토리/구성
스토리는 평이하지만 세자동차 이동씬은 화려했다	스토리/구성
이영화는 6점대가 적정하다고 생각합니다.연기도 좋고 스토리도 좋은데 몰입감이 떨어지네요.뭔가 억지스럽게 끌어가는 느낌입니다.	스토리/구성
영국영화도 상당히 독특하군요. 스토리야 있지만 영화로서의 재미는... 장편 독립영화도 아니고.	스토리/구성
감독의 연출이 부재니 좋은 소재를 말아버린다	스토리/구성
지금까지 본 한국공포영화중에서 내용이 꽤 신선하고 재미있었던 영화입니다.참고로 내용 이해하기 싫어하고 무조건 피터지고 때려잡는 좀비영화같은거 좋아하는 사람들은 별로 안좋아할듯. 스토리 위주의 영화를 보시는 분들은 재미있을것 같아요	스토리/구성
궁극의 러브 스토리! 내 생애 최고의 드라마. 다모폐인들은 영원히 잊지 않을것입니다	스토리/구성
진짜 내용 유치하네 작가 발로쓰나.. 연기자들 대본보고 손발 오그라들겠다.. 초반스토리에서 가면갈수록 진부해지네	스토리/구성
소재만 신선하고..연출,연기,각본 모두 기대이하... 맥아리없는 영화	스토리/구성
솔직하게 씁니다, 호러공포 매니아로 안본게 거의 없는데요, 4점대가 맞는것 같습니다. 우선 너무 흔한 소재와 너무 흔한 귀신과 너무 흔한 구성으로 색다를게 전혀 없고, 귀신찍는 사람들이 귀신이 귓바람 한번 불었다고 패닉에 빠져 허둥대는꼴부터 망	스토리/구성
어색,유치. 소재는 좋았지만 결정적으로 재미가 없으니..	스토리/구성
평점 높게준 사람들은 진심 영화 100편도 안본 사람들이다. 영화광으로써의 느낌은. 정말 짜집기만 한 어설픈 영화다..소재부터 스토리.. 모든게 진부하다. 결말역시 딱 캐나다식 엔딩이걸 어디 트라이앵글과 비교하는가. 감히. 에효...	스토리/구성
별거 아닌 스토리를 3차원적 진행으로 예술적으로 보이려 애쓰나 감독 본인도 이해안가는 잡탕	스토리/구성
재미있는 영화. 잘 접해보지못했던 신선한 소재로 잘만든 영화인듯	스토리/구성
따뜻한색감과 터치에 비해 너무 단조로운스토리가 아쉽다	스토리/구성
억지 공포감을 자내기엔 너무나 턱없이 부족한 각본과 감독의 재능.	스토리/구성
각본,연출등등..이것들은 둘째치더라도 주연 배우는 아무나 하는게 아닐텐데?	스토리/구성
지킬박사, 늑대인간, 뱀파이어, 프랑켄슈타인의 괴물까지 세계문학을 읽는 기분 !! 그리고 스토리와 액션도 사랑도 모두 최고였음!	스토리/구성
각본도 더이상 엉터리일수가 없네 원. 포르노인줄 모르고 벗은 여배우 불쌍함.	스토리/구성
감탄스러웠다. 무엇하나 지루하지않고 끝까지 여운을 주는 영화. 특히 스토리부분에서 굳	스토리/구성
소재도 좋고 스토리도좋고 good ~	스토리/구성
홉킨스를 안 써서 그렇지 솔직히 이거 괜찮은데요. 부족한게 머임? 책으로 읽어 봤는데 일치 할정도로 스토리 비슷하고 이 청년 렉터의 연기도 꽤 괜찮고 게다가 약 20년 동안 우리가 궁금했던 왜 렉터가 인육을 먹게 되는지 나오는데 머가 부족한가요?	스토리/구성
최악의 내러티브군. 내가 OOO이 나쁜건가 도대체 스토리가 이해가 안간다. 굳이 이해를 하고싶은 마음도 안생긴다만. 산만한 편집에 산만한 내러티브.	스토리/구성
대박..나일본멜로진짜좋아하는데이건정말최악...재미없음..보는내내집중안되는영화는이게쵝오!재밌다는사람은뭥미..초딩도집중못할듯...돈진짜아까움..아개짜증나지루하고뻔한내용에스토리자체가최악임..	스토리/구성
뻔한 스토리인지는 몰라도 불변의 감동~^^	스토리/구성
진심 지루함 스토리도 없고 ㅡㅡ	스토리/구성
영화 각본이 이게 뭐니.. 대사들이 너무나 단순하고 유치찬란하다.. 베드신도 야하지도 않고.. 에로물도 노출이 전부가 아냐.. 전혀 감성이 엄꾸만..ㅉㅉ	스토리/구성
왠만해서 사람 미워하지 않는 성격이고 각본에 의해 쓰여진 영화라는 것도 알지만 김윤진 정말 싫다. 진짜 안티카페라도 만들고 싶을 정도다. 대체 왜 이런영화에 이런역을 맡아 사람을 피말리게 짜증나게 하는가 내가 본 최악의 영화	스토리/구성
정말 최고다.. 영화중반부터는 동성애소재라는것을 잊을정도로 몰입되었고 장국영, 양조위의 연기에 깊게빠져들었다. 가본적도없는 아르헨티나에 가보고싶어졌다..90년대 아르헨티나의 배경은 너무 외롭고 감각적이다. 쩄든 희안하게 여운이 긴영화라서 계속 보게된다	스토리/구성
잘나가다 스토리 좀 유치하고 어색해짐;;;중간 넘어가면 억지 스토리가 좀;;;;	스토리/구성
도박이란 소제때문에 무조건 봤는데 스토리가 내가쓰는게 더나을듯,개연성,도 없고 몰입도 안되고, 높은점수 준사람은 전부 알바 티가 나네	스토리/구성
미친 이게 왜 재밌어?;; 시간낭비임 내가 지금까지 본 마블영화중 가장 최악이였음 러브스토리 낑겨있는것도 존내 이상하고 퀄러티만 좋은 B급영화;;; 톰 히들스턴때문에 억지로 참아서 봄	스토리/구성
경규아저씨 영화 꼭 대박나셨으면 합니다. 좋은 소재 영화 만들어주셔서 감사합니다. 이소연씨 넘 이뻐요.	스토리/구성
어우 진짜 스토리 구질구질하다 이전거랑 뭐가다르냐	스토리/구성
소재만 신비롭지...영상, 내용 그리고 배경음악 등이 왜이리도 촌스럽고 허접하게만 보이고 느껴지던지...	스토리/구성
영화를 장난으로 만듭니까 영화병맛임 목소리병맛 스토리병맛 동키를 왜 따라하는데	스토리/구성
음악, 영상은 좋지만- 여주인공의 성격과 스토리의 개연성 부족. 기독교인에게는 추천	스토리/구성
영화 스토리도 별로 코믹 유머도 별로 없고 김윤혜 뭐임 소녀에선 좋드만 [점쟁이들]에서 연기 최악 그래도 강예원의 연기는 좀 좋았음	스토리/구성
1편부터 변함없는 유치한 스토리 개그	스토리/구성
단순한 스토리지만 큰 지루함은 없다	스토리/구성
오래사귄 커플에대한 자세한 얘기를 풀어갔으면 했는데 너무 겉핥기로 끝난느낌. 뻔~하게 진행되는 스토리도 너무 아쉽다	스토리/구성
우리나라가 만들었다고 생각하니 너무 기분이좋아요다른나라 들의 애니메이션의 특유에 그림체가아닌 자기만에 그림체와 그리고 높은퀄리티 또 아름다운 효과가 이렇게 어우러진것이 스토리상 과 참잘맞는거같아요 ost도 너무 마음에들어요근데 마지막이많이아쉬워요?	스토리/구성
아.. 스토리어쩔꺼야,,	스토리/구성
원작의 감동을 20%도 재현하지 못한 졸작. OST 희재가 너무 뛰어나서 희재의 뮤직비디오로 보일 정도. 중간중간 너무 어색한 영화의 흐름과 뭉텅뭉텅 흘러가는 스토리는 몰입감을 떨어뜨린다.	스토리/구성
이게 평점 왜이리 낮은지 이해안가요. 각자 배우들의 다양한 러브스토리도 좋고 색감도 너무 좋았음 영상도 예쁘고.. 추천이에요 안소니밍겔라감독을 좋아한다면 더욱더! 매력적인 배우들이 산더미로 나와서 행복했음.,.	스토리/구성
헐리웃 로멘스는 이제 기대가 안된다. 소재 바닥 났슴	스토리/구성
8점대는 충분히 넘을 영화 보통의 히어로물과는 다르게 굉장히 현실적이고 섬세하게 영웅이라는 소재를 다뤘다. 그렇기때문에 아무생각 없는 무뇌의 보통의 액션히어로물을 생각했다면 지루하다고 느낄수도 있다. 생각을 깊게하고 본다면 많은 것들을 느낄 수 있다.	스토리/구성
일본의 슬로우무비랄지 별 스토리없는 치유계 작품을 좋아하는데 이 영화는 실망이었다. 등장인물도, 각각의 이야기도 작위적이고 매력없는 그저 무난한 영화. 뭣보다, 영화에서 위선적인 느낌까지 느껴졌다면 그 영화는 실패 아닌가. 에피소드 형식도 맘에 안든다	스토리/구성
유치하고 더빙한듯한 목소리하며 뻔한스토리..	스토리/구성
소재의 신선함을 이끌어가지 못한 영화........	스토리/구성
다시봐도 재밌네요. 조니뎁의 천연덕스러운 연기와 스토리 다 맘에 들어요, CG도 훌륭하구요..	스토리/구성
구성. 스토리. 배우들까지 정말 최고!!	스토리/구성
막장 스토리도 용서하는데 극장판이면서 프레임수를 날로먹는건 용서가 안된다.	스토리/구성
수준이하의 재미 단한순간의 깜놀도없었다. 결국엔 허접한 스토리까지.. 한국공포에 기대를 말아야지...	스토리/구성
불륜을 미화시켜도 너무 미화시켰어요; 영화인거 알고 불륜도 소재긴 하지만 보는내내 불편할 정도;	스토리/구성
이 영화는 개봉된지 어언 20년이 흘렀다. 이런 수작을 이제서야 볼 수 있게 되다니.. '의뢰인'이라는 영화 제목은너무나도 흔해서 옥석이 묻힌것을 못찾았던게다. 제작된지 상당시간이 흘러서 영화의 배경과 배우들의 의상은 적응이 안되지만스토리와 영	스토리/구성
진짜 이거 스토리전개가 너무느리고 엉켜있음 보지마세요	스토리/구성
정말 나쁜영화다. 최소한 케릭터에 오리지널리티가 없으면 스토리라도 좀 고민해야할거 아닌가? 편집붙여넣기 해놓고 뭐하자는건가... 내가 어린시절 좋아했었지만 이건 아닌듯...	스토리/구성
박평식은 대체 뭘 파란 거냐? 삼류 밑바닥 인생들이 저게 전부지 뭐 대단한 스토리라도 있을까봐?	스토리/구성
10점짜린 아니지만 잼있던데. 스토리는 딱히 별다를게없지만 이야기를 풀어나가는 스타일이 좋았음.	스토리/구성
공산당 선전은 언제까지 계속될까? 연출과 각본이 소재를 받쳐주지 못하고 여전히 굳건한 중국만의 프레임에 갇혀버린 느낌	스토리/구성
구성력에 아쉬움은 있지만 몰입도 하난 최고.. 이탈리아의 바다내음과 유럽풍 양식들이 이국적 향취를 더해준다.. 무엇보담도 등장배우들이 다 매력적이다..여배우 정말 정말 섹시하다	스토리/구성
아직 안봤지만 재밌을것같네요... 제2의 파이스토리 느낌이 드네요...	스토리/구성
액션도 아닌 멜로영화일뿐. 소재치기를 소재로 재미난 영화인 줄... 왠 로맨스 영화. 속았다.	스토리/구성
소재나 흐름등은 괜찬았으니 뭔가 사이사이 빼먹은 느낌이라 짜증났어요.	스토리/구성
지루한 전투신만 잔뜩. 1시간 반 넘어가면서 스킵하면서 봄. 스토리도 엉성하고. 배우가 아까운 영화.	스토리/구성
좋은소재, 아쉬운연출력, 개연성이 넘 부족하고 중심 캐릭터에 집중이 안된다.	스토리/구성
무턱대고 날라다닌다고 좋은 액션이 아니다. 스토리도 구성이 중요하듯 액션도 구성이 중요하다고 보는데 내기준엔 스토리뿐만 아니라 액션도 별로인듯	스토리/구성
영상과 구성이 뛰어난 수작.	스토리/구성
아버지와 아들이란 소재의 영화가 어떻게 전개가 될까 궁금해 하면서 봤는데 잔잔하면서 코믹한 사랑애의 따뜻한 영화를 볼 수 있어 즐거웠어요.감독님의 새로운 영화가 벌써 기다려지네요.	스토리/구성
스토리는 별로 인데 생각외로 재밌음 ㅋㅋㅋ	스토리/구성
동감 각본감독이라는게 믿을 수가 없다...	스토리/구성
재밌는 소재 하지만 초반부터 후반까지 계속 지루하고 끝나면 내가 이걸 본 시간이 아깝다	스토리/구성
디워 해외판 ... cg 연기 스토리 모두 엉성함 첨에 히드라 나올때 뿜었고 칼뽑을때 헛웃음나옴	스토리/구성
스토리도뒤죽박죽,재미,감동전혀없음 공감대형성전혀안됨=내평생최악의애니	스토리/구성
베를린 보고 이거 봤는데...역시나 베를린은 쓰레기 첩보영화였다...긴장감, 스토리전달, 굵직한 액션...완전 굿!	스토리/구성
스토리는 정말 귀신시나라까먹는 정말이지 쌩뚱맞다. 그냥 지루하지않아서 끝까지봤음	스토리/구성
두남자와한여자라는 소재를 두고 생각해낼만한 것중 지리멸렬한 것만 모았음	스토리/구성
전작만한 후속없다지만 그 좋은 소재를 이렇게 대충 써먹을수가 없다	스토리/구성
스토리, 분위기, 연기력 여태껏 봐 왔던 영화중에 개인적으로 최악중에 꼽히는 영화.단, 최민수 형님 연기력은 제외.. 형 본것만으로도 만족합니다;	스토리/구성
검색해보니 평점이 8점이라 보게됐는데..... 정석적인 권선징악.. 소재가 소프트웨어라 신선해보일 뿐이지.. 내용을 보면 유치찬란.. 중간쯤보다가 진짜 너무 졸렸는데.. 지금 자면 밤에 못잘까봐 꾹 참고 봤음..ㅎㅎ 진짜 불면증있으신 분에게 강추..	스토리/구성
영원이 연기 어색해서 깼지만 그래도 스토리 잼	스토리/구성
스토리도 탄탄하고 배우들 연기도 뛰어남 지금봐도 배경들이나 이러한 부분들을 정말 섬세하게 잘만듬	스토리/구성
잼께 보던 적이 조금있어서 2점 준다.스토리진행 최악	스토리/구성
여태껏본백설공주이야기중가장현실적이고슬펐다스페인특유의분위기와스토리가음악으로잘표현되어서눈과귀가즐거웠다	스토리/구성
80년대 영화지만 밑도 끝도없는 황당한 스토리 평점균형좀 맞춰야겠다	스토리/구성
소재만 감동적이면 다 10점주냐.... 오글거려 못보것다. 글고 제목이 아부지인데 아부지는 30분이 지나도록 콧뺴기도 안보이냐...	스토리/구성
배우도 연기도 스토리도 너무 좋당~~~	스토리/구성
스토리 엉성 연출력도 별로,,그냥 이것저것 다 짬뽕시켜놓구,,특히 마지막 장면 영화 허니 본 사람은 다 알 듯	스토리/구성
현실적으로 이 영화가 네이버 평점 8점이라는걸 믿을수없다 등장인물은 좋았으나, 스토리 전개도 엉망이고 무엇보다도 교훈적인 요소는 눈씻고 찾아볼수가없다.아버지는 아들에게 못다이룬꿈을 위해 강요하며, 끝까지 이용하려는 모습만 보인다. 신발 히갓은이쁘다	스토리/구성
진부한 소재로 도배했지만 효과와 긴장감은 그럴듯했다.	스토리/구성
소재가 상당히 좋다. 전환된후가 조금 흠이다. tv에서 한번쯤은 몰입해보자.	스토리/구성
소재가 신선했던 영화. 볼만 했다.	스토리/구성
그래픽으로 표현한 공룡은 괜찮다. 어린이들을 위해 유치한 개그와 진부한 스토리를 선보이는데, 어른이 보기엔 오글거리고 참고 보기 힘들다.	스토리/구성
각본의 무게감이 너무 아쉽다처음 마차신의 긴장감을 이어갔으면 좋았을듯원작에 비할수없는 영화	스토리/구성
평점 높아서 보다가 딱 기억나버렸다 중딩인지 고딩 시절 이거 학교에서 보고 멘탈이 와장창 깨진 트라우마 영화 마지막 장면에서의 쇼크로 토할뻔 했다. 아빠가 허...딸이 허...아오 이딴거는 소재로 삼지 말자 일본놈들아!!! 여학생에 뭐 원수 졌냐?!	스토리/구성
정말 특이한 소재 빼놓으면.. 아무것도 없다	스토리/구성
쓰레기같은 늙은이를 세인트로 만들려는 억지 스토리	스토리/구성
믿고보는 베네딕트! 스토리도 탄탄하고 재밌었다	스토리/구성
요즘봐도 밀리지 않는 특수효과, 신선한 소재,	스토리/구성
야구 소재 영화 중 손가락 안에 드는 수작. 희망과 꿈을 품고 키워가는 모든 이들에게 감동을 주는 영화. 특이사항으로 OB 김우열 선수 역으로 하정우가 단역으로 출연함.	스토리/구성
좋은 각본과 좋은 배우와 좋은 감독의 힘	스토리/구성
신선한 소재인데 뭔가 크게 확 끌어당기지 못한다.	스토리/구성
강태환 캐스팅 신의한수?? 뻔한 스토리 작가의 한게인가여?~~기대한만큼 실망도 크네요! 현실적으로 공감이가는 내용을 쓰시기를 바랍니다 PD선생님 권력이 그렇게 무섭나요???소신을 지키시기를'' 자부심을 가지시길 바랍니다 힘내세요!@@	스토리/구성
연기훌륭하고 스토리탄탄...	스토리/구성
스토리가 좀 아쉬운건있지만 감성적으로 본다면 아름답고 슬픈영화성룡과 김희선의 ost도 진짜 좋고 개인적으로 좋은 영화라고봅니다	스토리/구성
전염병 소재 영화로는 아직도 이만한 작품은 없지. 몰입감, 완성도 최고	스토리/구성
아~ 평점 보고 봤는데.. 낚였네.. ㅠㅠ 애들꺼라지만 이건 너무하잖아요. 스토리없슴,재미없음,감동없음.. tv에서했으면 채널이라도 돌리것드만.. 후덜덜 ㅡㅡ;	스토리/구성
완전지루해... 현실적으로불가능한스토리전개 돈내고봣으면욕해뜸	스토리/구성
Gr도 풍념이다 ㅋㅋ 메세지를 전하려면 개연성이나 보기 좋게 전달하지 이딴식으로 역겹게 표현해야했냐 1시간은 그나마 봐줄만한데 가면갈수록 개막장 스토리에 진자 답이안나온다	스토리/구성
이런무거운소재를 다뤄서 이슈화시키려는의도는좋았으나 개인적으로 재미가없었다. 흐름이매끄럽지않은듯한 느낌. 오열신은 대단했으나 동호의연기가더대단해서...짜증났음 왜이렇게밖에못만들었을까...까비	스토리/구성
진짜 매회열심히봤는데 요즘정말스토리 짜증나서 못보겠다스토리 말도안되고 뻔히보이는데도 강이경계속 착한게아니라 바보같아보이고 김하준은 강이경힘들게만하는 바보캐릭터같고ㅡ답답하고 짜증나네요 스토리전개를 좀빨리하던지ㅜㅜ 맨날 그날이그날이러다 정말 안보게될것같네	스토리/구성
이런류의 애니 원래 좋아하는데 재미가 없어서 스토리가 신선하다고는 못하겠다	스토리/구성
심리건 뭐건 필요없다.. 스토리가 좋아야지 주인공이 반성도 안하고 ㅡㅡ	스토리/구성
야동용으로 보려한사함들 반성해라 ㅡㅡ 보는내내 제시카알바 겁나귀여웟고 남자주인공도 괜찮앗다. 스토리도 뻔한스토리라고 볼수잇지만 배우들의 귀여움과 코믹함으로 다 커버쳐 줫다.	스토리/구성
스토리에 비해 연출이 아까움. 편안한 연출, 불편한 스토리.	스토리/구성
원작 요소들의 적절한 활용과 흥미로운 소재에도, 최악의 조명에 B급 영화로 전락.	스토리/구성
깊이가 있고 살면서 꼭한번 봐야할 영화인것같습니다 스토리 탄탄하네요	스토리/구성
돈 주고 본게 너무 아깝고 분해서 처음으로 평점 하나 날린다 연기도 그렇고 그래픽도 그렇고 스토리도 그렇고 모든게 엉성한 영화임배우들 발연기 죽여줌,,,, 중국 무협의 향수로 혹시나 하고 봤지만 역시나 였고 그 역시나 중에 최악임	스토리/구성
제레미 데이비스의 연기는 좋았으나 스토리는 흥미롭지 못하다.	스토리/구성
액션조 짱이고 여운도 짱이고, 캐스팅도 짱 스토리도 짱!정말 잼있게 본 들마였어요><!!	스토리/구성
배우들의 연기란 이것이다란 것과잘 된 각본이 무엇인지 보여주는 영화	스토리/구성
내 스타일은 아니다. b급을 지향하지만 어설픈 연기와 중2병급 스토리는 참기 힘들었다.	스토리/구성
신인작가가 쓴 단막극장 정도 스토리에 배우들은 다 하급이고 연기력도 하류	스토리/구성
20년 전이나 먹힐 소재	스토리/구성
진짜 구성 연출 연기 스토리 모든면에서 경악스러웠다. 악마의 영화.	스토리/구성
정말 색깔있고 느낌좋은스토리	스토리/구성
볼만함. 8점정도는 되는거같은데 문란한 스토리땜에 1점짜리를 많이받아 그런거같음.	스토리/구성
소재는 좋으나 매우지루함..	스토리/구성
한국영화는 x이다 지루해 너무지루해자꾸 억지감정 끌어내려고 하면 감정이입이 되겟는가스토리가 좋던 나쁘던 중요한게 아니다 마인드가 중요하지 마음으로 진심을 다해서 만들어라글고 배우들 눈알연기 리액션좀 자제하자 연기는 마음으로 진심으로 해주세요	스토리/구성
소재가 신선하네요 !	스토리/구성
전설! 오배넌의 정밀한 각본! 존-바뎀의 힘찬 연출! 냉혹한 두 명배우의 대결! 혼자서 전투기 편대를 잡고, 공중 덤블링하고, 도심 상공을 질주하며 테러를 소탕하는 슈퍼-헬리콥터! 천둥은, 주인에 따라 천사도 괴물도 되는 법! 21세기 공중전의 서막!	스토리/구성
평점이 너무 높다 난 개인적으로 애매모한 영화가 싫다. 웃음소재도 그닥...	스토리/구성
정말 최악의 영화입니다...뻔한 스토리 현실적이지도 굉장히 로코같지도 않은 애매한 스토리에.. 배우에 매력도 한껏 뽑아내지 못하고... 스토리표현방법도 ... 진짜 지루합니다...	스토리/구성
멋있지도 않고 오글거리고 스토리며 개연성도 부족하고 히로인도 매력없고 시간아까움	스토리/구성
나름 꿀잼 ㅎㅎ 내가 원했던 스토리의 영화 ㅋㅋ	스토리/구성
인간의 억눌린 욕구및 그해소를 물질 만능주의와 결합해서 결국 유지되는 부정적인 사회 모습을 소재로했으나 그로인한 범죄율 감소? 오히려 모든걸 한순간에 잃어 복수에 미쳐 날뛰는자들이더많을듯.	스토리/구성
이거보고 그래픽은 헐리우드인데 스토리가 용가리 수준이라고 했다가 주위사람들 한테 집중공격 당한게 생각나는구만.진짜 내가 본 영화중에 스토리가 이렇게 형편없는 영화는 다시 보기 힘들듯ㅉㅉ	스토리/구성
영상은 볼만했으나 스토리가 영상미마저 허접스럽게 만듦 제작비가 아쉬운 영화	스토리/구성
제목도 아류 스토리도 아류 김승우도 아류	스토리/구성
일판에 비하면 한참 떨어지는 졸작중에 졸작..... 스토리나 수술장면이나 여러곳에서 말이지...	스토리/구성
내가 좋아하는 배우들 많이 출연해서 악플은 안 단다.이 막장스토리에 배우들 연기는 정말 잘하네김응수.성동일 배우때문에 10점 줌.	스토리/구성
소재는 기발하지만 허술하다.	스토리/구성
재미도 없고 감동도 없고 스토리도없고 뜬금없고	스토리/구성
와...스토리 연기력 진짜 쩐다...이것이 영화지	스토리/구성
저예산이라고 봐주기엔..연기도 스토리도 화면도 너무 형편없다..관객이 돈을 지불하고 봐야할 이유가 없는 영화인듯.	스토리/구성
그냥 만들기라도했다고 3점이라는 후한점수 퀄리티가 높다는 평은 무슨소리인지모르겠음 스토리도 질이 너무떨어짐 옴니버스식인데 너무 딱딱끊어져서 다음이야기인지도모르겠음 기법만 볼만함 이영화 1시간을 돈주고 볼바에 픽사 단편애니 20분짜리를 그돈주고 보겠음	스토리/구성
스토리 아쉽고, 무얼 말하려는 영화인건지,,	스토리/구성
박신양 오버연기... 쥐어짜는 스토리도 별루.	스토리/구성
짧고 굵게 화끈한 영화ㅎㅎ 무삭제판도 스토리가 풍부해져서 재밌어요! 북미판이라 해외배송을 해야 되지만..	스토리/구성
스토리 쓰레기, 연기력 쓰레기, 브루스 10분 나오고..보면서 짜증 제대로	스토리/구성
엉성함과 황당한 스토리.. 막판 10여분으로 100분이 메꿔지지 않는다.	스토리/구성
ㅋㅋㅋ 애들이 주연으로 등장하고 눈물 연기 찍어놨는데도 감동없는 영화는 드물지 않나?? 80년대도 아니고 말이지, 스토리도 공감 안되고ㅋㅋㅋ 보다가 눈물?? 시끄러워서ㅋㅋ 차라리 옛날 영화 라이온킹 하쿠나마타타 한번 더 보는걸 추천.ㅋ	스토리/구성
스토리 발로씀. 초딩수준	스토리/구성
도전적인 19금 코미디가 될 수 있을 소재인데, 영화는 뻔한 내용에 지루한 개그들만 늘어놓는다.	스토리/구성
캐릭터마다 각자 개성이 있어서 재밌고 스토리도 재밌었다!!!기대 엄청하고 봤는데도 절대 실망주지 않았던 영화!!여자들이 좋아하긴 할거같다 ㅋㅋ	스토리/구성
박중훈씨는 사람이 밝아서 그런가 너무 해피엔딩을 좋아해. 이 스토리에서 좋게 끝내려니까 완전 어색하잖아	스토리/구성
엉성한 구성	스토리/구성
이거 진심 재미없음 영상미는 트랜스포머수준인데 스토리는 이리로 갔다 저리로 갔다 여자주인공은 이리저리 끌려다니고 시간 버리고 싶으면 보는게 좋을듯	스토리/구성
스토리가 전개가 너무 별로네.. 이건 뭐 옛날영화 죠스보다 못하는 수준	스토리/구성
그리 잼있지 않구나.. 띄엄띄엄 스토리전개 실망..	스토리/구성
신하균 연기 대단하다 스토리도 이정도면 괜찮다	스토리/구성
1탄보다 재미없다 초반부 스토리전개가 너무 느린듯 하다 보다가 중간에 지루함을 느껴서 깜빡잠이 들정도로..	스토리/구성
애니메이션 완전 조아~~~웬만한 어설픈 사람 얘기보다 동물 스토리가 훨~훌륭했던 한편의 감동 애니메이션이었어요. 강추~!	스토리/구성
긴장감없고 어설픈 스토리의 최악의 스릴러	스토리/구성
볼만은하나,독립영화치고너무흔해빠진스토리아입니까 독립영화특유의매력이없음	스토리/구성
재밌다! 내용도 신선하고 의미도있으며 연기도 좋고 영상도좋다~~	메세지/의미
도가 지나친 신앙심의 말로. 종교인에게도 비종교인에게도 전하는 메세지가 뚜렷해서 좋음. 강추~!!	메세지/의미
하감독님 21세기는 순정영화도 시가 아니라 긴장감과 메시지가 있어야 먹힌 답니다.	메세지/의미
정말 의미있는 영화. 좋은 주제를 잘 찍었다.	메세지/의미
저기...전하고자 하는 메시지가..	메세지/의미
담으려는 의미는 좋았으나 노골적이고 엉성하고 어설퍼서 집중하기 어려웠던 영화.	메세지/의미
이런 스타일 영화가 참 좋은데 21세기에 들어선 이후로는 주로 블록버스터가 많아서 나오지 않는 것 같다. 전하는 메세지도 있어서 더욱 좋다.	메세지/의미
옛날에 봐서 기억이 가물가물했는데 충격적이었던 결말만은 영화를 다시보는 내내 떠올랐다. 결말이 뭘 의미하는지 까지는 기억이 나지 않았다. 그때 당시의 충격으로 마지막 장면이 머리에 박힌것같다. 다시보고나니 잊을수 없을만한 장면이 맞는것같다.	메세지/의미
트레버로 부터 받은 메세지..	메세지/의미
작위적이고 뻔한데 메시지만 강요.	메세지/의미
그림 막 거지같이 그려놓고 깊은 의미가 있다고 찾으라는 격...많이 모자라는 영화..	메세지/의미
역사 의식의 의미 조차도 모르는 늙은 쥐색히가 역사를 모독하였으니 극형에 처해야 마땅하다.	메세지/의미
마지막 싸움신은 록키시리즈중에서도 최고. 의미적으로도 딸리지않다.	메세지/의미
재미도 메세지 전달도 실패	메세지/의미
관객을 조롱하는 영화. 의미없는 러닝타임	메세지/의미
진짜영화많이보고 완전쓰레기같은영화도 욕하면서도 끝까지는 다보는데, 이 영화는 진짜 보는내내 너무 지루하고졸려서 잠들길 두번. 삼일만에 겨우 엔딩봣다ㅡㅡ 진짜 지루하고의미도 없는 영화. 이런 막장콩가루집안을 그려서 감독은 뭘 말하고 싶은지..	메세지/의미
홈비디오 이전 포르노 전용관 시절에 만든 그냥 성인물같다.. 사람들이... 너무 많은 의미부여를 하는 것 같다...전혀 에로틱하지도 않고 그저 고어물처럼 징그럽고 기괴할 뿐...흥행도 별로였을 것 같고 그저 스케일만 큰 실패작인 것 같다.	메세지/의미
사다코2는 3D + 스마트폰 4D 없이는 의미가 없는 영화	메세지/의미
영화가 끝날 때 마치 멜로 영화를 본 것 같았다.한 남자,한 천재가 사랑하는 사람에 의해 삶의 의미를 찾고 그 사람을 위해 모든 것을 헌신하는 모습에 감동받았다.	메세지/의미
우연찮게 보다가 한 여자의 삶에 동화되어 눈물지었네요 궁금한거 하나 크리스가 기도하자며 웃옷을 벗었을떄 예수님의 형상이 왜 나왔는지 알겠어요 죄책감에서 벗어나라는 메세지죠	메세지/의미
이 영화의 평점이 의미없는이유전국관객수 53명인데 리뷰는 100개가 넘는다는점알바그만하시죠?	메세지/의미
날 사랑해주는 사람들을 다시 한번 생각하게 만드는 의미있고 감동있는 영화	메세지/의미
Gr도 풍념이다 ㅋㅋ 메세지를 전하려면 개연성이나 보기 좋게 전달하지 이딴식으로 역겹게 표현해야했냐 1시간은 그나마 봐줄만한데 가면갈수록 개막장 스토리에 진자 답이안나온다	메세지/의미
미국여성이 지휘한작전아래 아랍여성이 의미없이 죽는 장면이 나올땐 왠지모를 구역질이 난다. 테러에 테러로 응해 수장을 잡은것은 전쟁영화니까 리얼함에서 인정하겠지만 마지막장면은 너무 전형적이라서 좀 짜증난다. 잘만든 영화이지만 감동을 주는 영화는 아님	메세지/의미
아무리 발버둥쳐도 어느 거리 이상 가까워질 수 없는, 그 사람이 싫은 게 아니라 본질적으로 너무나도 나와 다른 사람의 존재를 겪어보았다면 이 영화가 조금은 의미있게 다가올 듯 하다.	메세지/의미
다큐보다 전해지는 메세지도 없고 그렇다고 다른 영화보다 재밌는 것도 없고... 머 이래저래 애중간한 영화다	메세지/의미
보지마십시오 시간이 남으신다면 의미있는곳에 쓰기바랍니다	메세지/의미
홍콩판 씬씨티 그치만 나름 전달하려는 메시지도있고 아주 재미있게봤어요.	메세지/의미
알다가도 모르겠지만 의미있는 영화라는건 확신한다	메세지/의미
현란하고 정신없으며 자극적인 영상들로 가득하지만, 이게 공포나 스릴로 이어지진 않는다. 교회, 성흔, 복음서 등 기독교 요소는 의미 있는 무언가를 만들지도 못한다.	메세지/의미
대단하다.. 물론 원작에는 못미쳤지만 그 거대한분량과내용을 2시간도 안되는 시간으로 만들어낼수있다니 영화도 훌륭하지만 원작자체가 너무훌륭하고 많은내용과 의미를 내포하고있어서 다풀어내기에는 확실히 역부족이었겠지그래도 출연배우들 다나와서 정말 아련했다	메세지/의미
메세지 전달에 포르노 수준의 장면들이 필요했던 것일까 관심이 필요했던 것일까	메세지/의미
지금 나오는 영화들보다 어쩌면 그 시대적 배경을 잘 묘사하고 전달하고자 하는 메세지도 잘 전달한 것 같습니다. 너무 감동받았습니다.	메세지/의미
로드 투 퍼디션 보다 재미 있고, 의미있다.. 근데 로드 투 퍼디션 이랑 중요한 설정이 완전 똑같은데.. 이거 머임? 표절? 리메이크?	메세지/의미
영화의 의미를 파악할수 없었다. 장면 연결이 부실하게 느껴졌다.	메세지/의미
3가지의 에피소드가 많은걸 의미한다..강추	메세지/의미
내 살면서 이런 영화는 첨 보네. 스토리도 없고, 주인공이 별다른 능력도 없고, 아무 의미없는 대사만 느릿느릿 국어책 읽듯 읊어대고, 어떻게 끝나나 겨우 봤더니 정말 황망하게 끝나네. 혹시라도 볼 사람 있을까봐 글 남깁니다. 절대 보지 마시길.	메세지/의미
메시지를 전달 하려고 했는데...시나리오가 개차반...ㅉ	메세지/의미
다시 보게 되는 영화. 대외 홍보 내용과는 달리 작품 속에 묻어나는 메세지와 표현이 독특하다.	메세지/의미
① 지금에 와선 역사적 의미 밖엔 없는 영화인데, 평점을 높게 주는 건 ..	메세지/의미
단순하게 보면 재미있겠지만 그속에 담긴 메시지는 결코 곱게만 볼 수 없다.	메세지/의미
어린이 만화에서 필수 코드인 용기와 열정뿐 아니라 낯선세계 속에서 성장하는 아이들과 디지몬들의 모험속에 담긴 인상적인 메시지까지. 어린이 만화라는 타이틀을 집어던지고 비교해봐도 역대 애니메이션들 중에서도 꼽을 만한 명작이다.	메세지/의미
충분히 잘만들 수 있는 소재인데배우들의 다소 어설프고 과장된 연기와몇몇 무의미한 부분에 집착하는 연출이제 살 깎아먹은 꼴이 되어버렸다	메세지/의미
전 의미 있는 노래를 매우 좋아합니다. 노래를 부르는 데 목소리도 빠지면 안 된다고 생각합니다. 그게 빠지면 보기 싫어요.	메세지/의미
뻔하디 뻔한 3류 액션 첩보물. 배우들의 연기력은 너무나도 어색해서 보는 내가 다 민망해지고 거기에 한방씩 맞아주며 쓰러지는 악당들에게 한심함마저 느껴질 정도... 칭찬을 하려해도 할 곳이 없는, 어떤 의미론 정말 굉장한 영화	메세지/의미
백설공주라는 데 의미가 전혀 없는 것 같아. 보면 후해할 겁니다.	메세지/의미
이거 감독이 누가 길예르모래?뭣도 모르면서 판의미로 감독 명성 더럽히는데ㅋㅋ니들도 여기 애 아빠랑 다를거 없어	메세지/의미
와..이영화 머임? 강동원 얼굴볼라고 끝까지봤다만 보는내내 오글거림으로 고문당하는 느킴ㅜㅜ 재미도 감동도 의미도 없는 영화	메세지/의미
합당한 복수라고 해서 재밌을거란 의미는 아니다 ㅡㅡ	메세지/의미
마지막이 좀 씁슬하지만 의미가 확실한 영화/ 배우들의 명연도 한 목 하였다.	메세지/의미
어려운영화다 뭔가 의미있는 말들이 많이 오간것같은데 잘 이해를 하지못했음ㅋ 스토리전개도 지루했고 개봉전부터 많이 기대했었는데 보고나니 별로였다	메세지/의미
지루하다. 한 없이 늘어진다. 평범한 미스터리 추리극 가지고는 흥행이 될 수 없음을 여실히 드러낸 영화. 집단 이기주의에 대한 메세지 말고는 그 어떤 감정도 느낄 수 없었다.	메세지/의미
당시 한국 공포영화로서의 의미는 있겠지만, 영화 자체는 재미가 없다.	메세지/의미
쓸데없이 평점 높은 영화. 아무런 스릴감도 없고 재미도 없고 무섭지도 않고 의미도 없고. 제목이 제일 무섭고 제목만 재미있어 보임. 7점대 평점에 낚였다.	메세지/의미
감독이 전하는 메시지는 좋았으나... 주인공 남, 여 빼고 외 남자 3명이 받쳐줘야하는 부분에서 연기력이나 행동들이 너무 성의없이 보였다.. 1인4역보다 1인 다역을 하는게 평점은 더 좋지 않았을까? 평점은 남여각각 3점 감독3점 남자3명 -2점	메세지/의미
의미있는영화 잘봤습니다	메세지/의미
2 % 아쉽다는 평이 생각보다 많네... 개인적으로 내가 본 최고의 극장판이였다. 게다가 원작에 전혀 꿀릴 것 없는 스토리,메시지, 그리고 원작을 뛰어넘는 퀄리티는 환상적이고.	메세지/의미
영화의 80%까지는 아무런 재미도 의미도 없이 흘러가다가 마지막 20%에서 뭔가 보여줄 듯 자세만 잡고 결국 아무 것도 보여줄 게 없었던 영화.. 핸드헬드는 이제 좀 그만 써먹기를..	메세지/의미
메세지를 위해 무참히 희생되는 개연성,도덕성,현실성	메세지/의미
8점을 하고싶으나 평점이 좀 낮아서... 9점 클릭 했어요 그리고 영화가 전하고자하는 메시지가 상당히 많고 좋았습니다. 예지원씨 연기력도 굳!	메세지/의미
군더더기 없는 연출과 사무라이 전투씬이 볼만했고, 대의라는게 과연 무슨의미일까 라는 의문 또한 남겨준다.	메세지/의미
기대가 되는 영화네요 다른의미로	메세지/의미
대부분 가볍게 킬링타임용으로 보기 좋다는 평이라 의외네요. 단순히 킬링타임용은 아닌거 같고, 주인공의 환경이 던지는 메시지가 있는 영화인거 같습니다. 정말 괜찮은 영화입니다. 추천~	메세지/의미
정말 강력한 메시지. 이렇게 직설적인 영화 오랫만. 정경호 연기 정말 좋다.	메세지/의미
"""영화 의미를 못찾고 있다가 이지혜 저널리스트 평가글 보고 수정함 딱 그분 말 그대로입니다 """"신이든, 술이든 붙잡을 것이 없으면 살아갈 수 없는 인간의 연약한 본질"""" 내용 흐름이며 배우들연기 훌륭하고 좋은 영화라 생각합니다"""	메세지/의미
50년이훨씬지났지만 지금봐도 전혀촌스럽지않은 명품스릴러 새파랗게젊은시절의알랑드롱 지금시선으로봐도최고의미남	메세지/의미
평점이 너무 높다. 던지는 주제는 알겠다만 제대로 전달을 못한걸 난해하다고 표현하는 분들이 많다. 전반의 몰아치듯 던저주는 질문과 메세지는 후반부에 들어서자 그 버거움에 스스로를 옭아맸다. 8점까지는 가지못한다.	메세지/의미
어떻게 생각하느냐에 따라 다른듯 사람들이 왜 욕하는지 이해는 가지만 그래도 꽤 의미가 있는 영화였음 평점 올리려고 10점 남긴다	메세지/의미
토비.리즈의 풋풋한 모습도 의미가 있지만 작품 완성도에서도 훌륭하다고 생각합니다.	메세지/의미
감독이 자신의 메세지를 전달하지 않고 관객에게 해석을 떠 넘기는 전형적인 싸구려다. 결국 메세지가 없는 영화는 쓰레기라는건 평범하지만 당연한 원칙이다 . 똥 싸놓고 된장이라고 우긴다는 표현이 이 영화에 딱 맞는다.	메세지/의미
몇년 사이에 평점이 무진장 높아졌네.. 좋은 메세지가 담겨있지만 다시봐도 여전히 지루한 연출.. 6점!	메세지/의미
불륜영화가 아니라 인권영화였다. 강한 메세지가 돋보이는 수작.	메세지/의미
이영화가 남겨준의미가 도대체뭔지 한번 물어나보자라니?? 볼줄모르면 그냥 영화를보지말지 잘만들어논영화를 1점주고 어휴 수준이하	메세지/의미
지루함의 연속 큰 의미도 없다.	메세지/의미
유재석도 유재석이지만 애니영화 중 이렇게 강한 메시지를 줄수있는 영화가 있을까? 솔직히 애니영화지만 뭔가 큰교훈을 얻은듯 했다	메세지/의미
뭔가메세지가담겨있는것은같은데....도통뭔지를모르겠어요!냉정하게평가합니다.	메세지/의미
고딩일진 영화가 아니다. 공감할만하고 메시지가 있는 영화다	메세지/의미
부부간의 사랑의 의미를 되새겨볼 수 있는 좋은 영화	메세지/의미
별 의미 없는 영화에서 의미를 찾는 것은 골 아픈 일이다. 9곡이 넘던데...	메세지/의미
의미를 찾을내야 찾을 수 없다. 아이고 의미 없다.	메세지/의미
아, 최고!!! 제목의의미를수십번곱씹어보게되는...추천합니다.	메세지/의미
최고의미드다..	메세지/의미
최고의 영화입니다. 스토리, 배경, 음악, 메시지 모두 훌륭하네요	메세지/의미
감독님과 학생들, 관계자분들이 너무 고생이 많았을거 같아요~ 그 덕분에 저는 편안한 극장 안에서 더 넓은 세상과 지난 제 삶을 돌아보는 의미있는 시간을 보낼 수 있었습니다. 절망 속에서 피어난 희망.. 평생 잊지 못할 소중한 영화가 될거 같습니다^^	메세지/의미
의미를 좀 알고보시길... 우리나라 포스터부터 바꿔야할듯^ ^	메세지/의미
영화보고 바로 감독검색해보긴 처음이네.머 이딴영화가 다 있어. 다보고 나면 완전 짜증나는영화.반전도 없고 메세지도 없고 있는척은 있는대로 다해놓고 17년전의 약속같은 소리한다.진짜.ㅡ.ㅡ;	메세지/의미
혐오스런 마츠코의 일생과 동급, 혹은 그 이상으로 놓고 추천을 하길래 봤더만, 에라, 똥 밟았다. 감독이 던지려는 메세지는 뭔지 알겠으나, 전개방식이 개같다. 뚝뚝 끊겨. 불친절한 감독의 자위물. 빠들은 필시 들뢰즈, 라깡 읽고 개소리 후까시잡는부류.	메세지/의미
따뜻하고 아기자기하면서도 발칙한 스토리. 애기들의 귀여움도 귀여움이지만 남편과 바람핀 여자의 화장품가게를 엉망으로 만드는 영화 라붐의 한장면을 보며 웃는 콜레트의 모습이 현실적이고 씁쓸하다. 사랑과 죽음의 의미를 되새기면서도 귀여웠던 영화.	메세지/의미
소오강호 바로 인생무상, 무협이지만 정말 의미있습니다	메세지/의미
기존에 나온 총쏘고 부시는 전쟁 영화가 아닌 의미있는 영화였다... 감동 ㅠㅠ	메세지/의미
감독의 의도는 인간의 잔인성을 통해 현대인의 이기주의를 파헤친다고는 하지만, 특히 여성에 대한 가혹한 묘사가 혐오스럽고 영화주제와는 무관하다. 결론적으로 이 영화의 메세지는 그냥 포장인거고, 스너프필름과 포르노의 합작이라고 보면 맞다.	메세지/의미
아이고 의미없다. 일본영화의 몰락	메세지/의미
풍자를 위해서 '카자흐스탄'이란 나라가 똥이 되던말던... 메세지의 전달 문제보다 미국인들에게 익숙치 않은(이게 선정이유겠지만) 카자흐스탄을 통해 풍자 메세지를 보내는 것 자체가 아이러니하게도 굉장히 위험한 사고방식	메세지/의미
평점이 무슨의미가 있을까?... 국내개봉작이라는게 놀랍다...	메세지/의미
빅오나아르젠트소마에 열광한적이 없는 넘들은,평점남긴다는것자체가 무의미...감독 카타야마카즈요시가 극우성향의애니신해저군함을 연출한적이 있다고해서,달려드는 넘들이,지지하는 정당은 맨날,세누리당,정치가는 맨날 유신공주 박모여사,너희들의이중성에 경의를 표한다	메세지/의미
좋은영화인데 평점이 낮아 안타깝네요. 연평해전을 흥미를 목적으로 본게 아닌것처럼 앎을 목적으로 본다면 큰 도움이 되는 의미담긴 좋은영화입니다.	메세지/의미
보여주기 위한 영화...내용이 난해다니기보다는 정말 의미 없다	메세지/의미
정말 감동적인 최고의영화가 될뻔했는데 희망적메시지를 전달하기위해 그냥 괜찮은영화가 되어버렸다.그래도 정말 독특하고 재미있는영화임에는 틀림없다.	메세지/의미
메시지야 그럭저럭, 한국정서로는 이해 안가는 운명이해론.	메세지/의미
다들 보게되신 경로가 비슷 저역시 금성비디오 살때.. 많은의미가 있는영화.	메세지/의미
나름대로 의미있는 메시지를 전달하려고 노력한 흔적이 보이나...90년대초의 영화를.	메세지/의미
음악과 함께 전해져오는 메시지 !!	메세지/의미
모두에겐 불안함이 잇다 하지만 사회라는 틀에서 억압되고 끝없이 잠재되어 속이고잇다 그러나 난 이영화에대한 객관적인 평가마져 속이고 싶지않다 메세지에 비해 실속없는 대사와연출 무서운ost하나 없는 이영화는 양날의 칼날이다	메세지/의미
뭔놈의 다큐가 논점도 없도 의미없이 지루하게 허접하게 어설프게 러닝타임만 졸라게기네 평론가 허세평점.그저 영화제영화라면 빨아대면 내가 수준이 높다 싶은거냐? 니들 수준 안목 내 발밑이다.이딴 허접다큐에 7점이상 남발한 평론가들은 평론가 자격박탈.	메세지/의미
사실적인 감동을 추구했으나 리얼리즘도 약하고 스타일리쉬도 아님. 무의미 B급.	메세지/의미
사랑의 의미가 돋보였던 영화에요..	메세지/의미
이 영화에 나오는 잔인한 부분은 시각적으로 자극을 줄려고 만든 것이 아니라 영화가 전달하고자 하는 부분들을깊게 나타내기 위한 요소로 느껴져서 너무 좋앗습니다. 고통이 가지는 의미 전쟁의 참혹함.. 마지막 부분의 여운은 정말.... 최고네요ㅜㅜ	메세지/의미
침묵속에서 관객에게 어떤 메세지를 주려는지 알수 없는 재미를 느끼지 못하는 영상물	메세지/의미
하~~~~품. 모자이크 ^^ 그냥 웃음이 나오네. 줄거리.의미 다필요없구 호모를 위한 그냥 재미없는 호모영화	메세지/의미
살육과 잔인만이 팽배하다. 그 이상의 의미는 없는 스릴러.	메세지/의미
모든것이 섞이는 큰강이 아닌 건널수 없는 의미의 큰강같다	메세지/의미
아 정말 취향탄다 이건 영화에 대한 모독이다 의미만 전달하면 전부 영화냐??	메세지/의미
원작 파악은 제대로 하고 만든건지 캐릭터 붕괴에 스토리도 엉망..전작들은 보고 나면 메세지가 남았는데 이건 뭐하자는건지 모르겠음 더큰건 성우를 싹다 바꿔서 몰입도 안됨 솔직히 프리퀄이라 걱정되면서도 기대했는데 진짜 엄청 실망함	메세지/의미
교육적인 메시지와 영화 주제가 너무 감동적이였어요 올여름 강추 애니입니다	메세지/의미
메시지가 좋다. 누구나 다 화려한 청춘일 순 없지. 내 인생의 잉여만 안되면 되는거임.	메세지/의미
구구절절 설명하고 이해시키려는 노력이 큰 의미없이 다가온다. 차라리 이유없는 사이코패스를 그려내는 쪽이 나았을듯. 괜찮은 아이디어와 흥미로운 장면들이 꽤나 있지만 팀장의 연기력이 끊임없이 맥을 끊는다.	메세지/의미
마을이라는 곳, 공도체라는 것, 함께 산다는 의미에 대해 좀더 깊숙하게 생각하게 되었네요. 혼자가 아니라 함께 한다는 것!	메세지/의미
인간의시간여행에 대한 의미있는 메세지도 담고있을뿐더러 시간파라는과학적장치로 더볼만했고진화는 파충류의 승리같은느낌.발에밟힌 나비도 나비효과를 상징적으로 말해주는것같고 사소한것하나도 시간의 끝엔 사소한게 아니다 시간여행이가능해져도 막자 핵과 원자력처럼요	메세지/의미
이걸보고 재밌다고, 의미 깊다는 말들은 허세로 밖에 보이지 않는다.	메세지/의미
영화가 나온지 1년 가까이 되는 이 시점에서도 리뷰를 남기는 이유는, 내가 받은 감정의 카타르시스가 영화로는 만족 못해서가아니라 영화가 단순히 영화 이상의 의미로서 내게 무언가 전달 되었기 때문이리라. 천우희라는 배우에게 아낌없는 찬사를 보내고싶다.	메세지/의미
이영화 만든 감독의 의미가 뭘까 ㅡㅡ	메세지/의미
겉은 있어보이는데 안에는 별거없는 영화. 컨저링보다 무섭다길래 봤는데 그냥 별의미없는영화본거같음	메세지/의미
레이첼덕에 3점 영화가 아닌 영상이라고 생각하고 보는것이 현명하다. 감독이 영화 내 에 의미를 부여하려는 의도가 다분히 보이고 '나 예술영화 만들고 싶어요~.' 라는 티도 많이 나서 보는내내 부담스러웠다. 특히 가장중요한 재미가 없다.	메세지/의미
지난 13년간 나의 삶은 그냥 그렇게 지나갔다. 나의 모든 것이라 여겨졌던 것이 정말로 생각지도 못하게 갑자기 떠나버리기도 하는 것이다. 나는 내 삶의 의미를 이제라도 찾아야 한다. 다른 사람이 아닌 오직 나를 위한 새로운 의미를.	메세지/의미
내 인생영화. 풍부한 스토리와 긴박감, 섬뜩하면서 아름답기까지한 조커의 광기와 몇번을 봐도 질리지 않고 많은 철학적 메시지를 전하는 최고의 걸작!	메세지/의미
재미도 없고 의미도 없는 영화	메세지/의미
복수도 어느 정도 말이 되고 타당성을 근거로 해야 의미가 사는 건데 이건 거의 찌질한 수준이니 뭐라 할 말이 없네요...	메세지/의미
짜증나는. 의미도 내용도 없고,가끔 카메라 각도는 잘 나온게 있어서 별하나.	메세지/의미
'죽음'에 대해 생각해주게하는 영화..내포된의미를 알고보면 반전이 쌩뚱맞지 안은..	메세지/의미
처음 볼 때에는 프랑스 정서가 익숙하지 않아 두 번 봄으로써 영화를 제대로 이해했다. 여지없는 연인의 사랑 이야기다. 진정 사랑해 본 사람만이 이 영화가 주는 감정과 육체적 사랑으로 인한 메시지를 이해할 것. 그리고 이별 후에도 남는 애틋한 마음도.	메세지/의미
아버지가 찾은 진정한 미각과 음식의 의미	메세지/의미
뭐야이건?? 의미도없고긴장도없고.........................	메세지/의미
차라리 추격자를 40번 보는게 훨씬 낫겠다. 메세지도 거지같고 자살방지는OO	메세지/의미
무언가의미있는것을 말하려해도 역시 뻔하고 단순한 액션의 한계를 못넘는다.	메세지/의미
솔직히 영화를 끌어가는데 지루함이 좀 있지만 전하고자 하는 의미와 여운이 큰 영화이다. 요즘 나오는 상업영화는 결코 따라오지 못할 힘이 있다. 이병헌은 영화에서도 이루어지지못하는 일을 현실로만든, 그때도 역시 연기력이 대단했던 배우다	메세지/의미
묘사와 의미는 Good But 시대적상황과 현실을 보더라도 분륜녀와 그딸과의 개연성은좀	메세지/의미
전달하려는 메세지를 내가 못 읽은건가?....	메세지/의미
의미있는 영화다. 재미 의미 영상미	메세지/의미
좋습니다! 사태의 심각성을 느낄수도 있었구요.근데 저는 생각이 약간 달라서.가족의 생활사에서 어머니의 행동이 분명히 '피해'였다고저는 생각합니다. 좋은 취지였지만 아들과 아버지에게는ㄱ고통이었달까요 더불어 명확한 대안이 있는, 메세지의 부재	메세지/의미
아무런 의미가 없는 개봉날짜...	메세지/의미
거스를 수 없는 시간과 운명.. 그렇기에 더욱 소중히 여겨야 할 '현재'의 중요함에 대해 역설하는 영화.. 메시지도 좋지만, 특히 시간을 역행하는 벤자민의 모습을 표현한 분장이 굉장히 뛰어나다.	메세지/의미
신인감독들의 입봉작이라 험한 말은 하기 싫지만 많이 노력하시오. 각본 2점 편집 2점 연출 3점 연기 7점, 그나마 악역연기는 좋았다. 특히 각본은 한숨나올 정도로 못썼다. 추적60분보다 재미도 의미도 없는 영화를 굳이 만들어 상영하는 이유는 뭐냐	메세지/의미
나도 영화 꽤나 본다는 사람인데 당최 재밌지가않네 이게 자서전적으로 영화까지 만들만한 사건인가정녕 스페인에서 내내 술이나마시다 왔다는얘기? 그런의미에서 제목은 기가믹히게 짓긴했네	메세지/의미
별점 10점 주는 사람들은 정말 이 영화에 대해 큰 착각을 하고있는거같다. 정말 무의미한 롱테이크샷이 난무하는 지루하기 짝이없는 영화. 대사도 솔직히 진짜 식상한데 뭔가 대단히 철학적인 내용인 마냥..의미없는 연출, 의미없는 대사. 인디영화의 겉멋.	메세지/의미
생명으로써의 동물과 육식, 동물의 삶의 의미와 경제동물로써의 가축에 대한 균형있고 진지한 고민이 돋보였다. 코미디와 캐릭터 속에 꽤 깊은 성찰과 감동이 들어있다. 여운이 남는 작품.	메세지/의미
메세지가 있다고 다 좋은 영화는 아니다. 메세지는 어느 영화나 있다. 그 메세지를 어떻게 개연성있고 효과적으로 잘 전달하느냐가 문제지. 나홀로집에 케빈의 수준을 군인들에게 적용했다는게 가장 큰 문제다.	메세지/의미
글쎄요... 뭔가 전달하는 의미를 표현하는게 부족한듯	메세지/의미
쓰레기같은 연출, 쓰레기같은 메세지	메세지/의미
가족의 의미를 다시 생각해볼 수 있는 감동적인 영화	메세지/의미
이 영화에 어떤 의미를 두어야 할까?한마디로 일단 너무 지루하고 재미없다!	메세지/의미
몇번이고 보면 볼수록 새로운 의미가 와닿는다는데...뭐 다시보고 싶어야 다시보지 내가 새로운 의미를 찾을 일은 없을 듯.	메세지/의미
의미없고 지루해	메세지/의미
18살에 보고 지금 6년이지났다 어릴때 무슨 내용인지 어떤 메시지를 담앗는지 이해를 못했는대 지금 보니까 참 내인생에 꼽을수있는 영화다	메세지/의미
나름 새로운 시도를 했다는 의미에서 완전 OOO는 아니라고 해줄게	메세지/의미
옛 영화라 그런지 더 아날로그감성에 젖어들 수 있었던..자신은 사랑하는데 그 사랑을 몰라주고 받지 못하니 이렇게 집착이 되는거겠죠,. 외로움을 가지고 있는 여자에게 사랑의 의미는 너무나도 크니까...하지만 집착은 끝내 서로를 파멸시킨다는거. 짠하네요	메세지/의미
영화의 의미, 그것이 무엇인지 느낄 수 있다.	메세지/의미
오락만으로 절대 즐길 수 없는 소재고 그렇다고 의미를 두고 보기에는 너무 지나치다는 생각이 든다. 일본 스릴러를 굉장히 좋아하는데도 거부감이 들정도의 영화, 그렇다고 재미없는 건 아니다.	메세지/의미
고양이를 사랑하자는 메시지를 부추기는 영화. 굳이 알고있는 내용을 굳이 공포영화로 만들어야 했을까. 고양이가 공포적인 분위기를 담아내기엔 부족한 부분이 많았다. 평소 공포영화를 좋아하시는 분들은 이 영화를 보고 다소 실망이 클거 같다.	메세지/의미
저에게 많은 얘기를 들려주는 영화네요.. 사랑도 메세지도 참 좋아요 !♥	메세지/의미
시청률에 좌우치않고 소신껏, 나타내고자한 메세지를 훌륭히 전달한제작진에게박수를.	메세지/의미
허세들 ㅋㅋㅋ 진짜 재밌는 영화는 억지이유 들어가며 깍가 내릴때로 깍아 내리고 이런 지루한 영화의 의미부여는 마치 등살부터 모은 트리플 a가슴과 같이 하는 것들 배우들이 아깝고 또 아까운 영화	메세지/의미
신랑이랑 13년 전에 사귀기 시작하고 본 첫 영화예요 ㅋ의미도 있고 재미도 있었구요~	메세지/의미
평론가를 위한 예술영화. 나에겐 별로여도 이런 영화 찍는 감독도 필요하리라 본다. 마지막 10분이 넘는 메콩강 롱테이크샷보면서 어설픈 의미찾기나 꿈보다 해몽식의 미사여구 생각지말고, 한강가서 10여분 거니는걸 추천한다	메세지/의미
무슨 메세지를 주려는건지 모르겠고, 황당하고 짜증나서 중간에 나와버렸다.	메세지/의미
다시 볼 때마다 조금 씩 더 영화에 다가가고 그 때마다 인생의 의미를 조금씩 더 알게 된다.	메세지/의미
전혀 의미없는 욕의 난무	메세지/의미
노장 데려다 의미 없는 의리/겉멋 마무리나 시키다니.	메세지/의미
실화로서 메세지가 잘 전달됨. 극적인 건 별로	메세지/의미
원제목도 나름 중요한 의미가 있는데 포화속의 우정이라니....;;;	메세지/의미
가끔가다 생각한다. 생각은 관객이 저마다 다르니 그들 나름의 생각을 상상할수 있도록 하고자 했다고.... 상상이나 할수 있을 최소한의 메시지라도 던져놨으면 한다.혼자만의 메시지가 모든 사람들에게 다 읽혀질거야란 생각은 좀 아니지 않나 싶다.	메세지/의미
저예산 독립영화풍으로 그려냈지만 오히려독립영화를 욕보이는영화같습니다. 가슴한켠 남는것없이 의미없이 지나갔습니다. 악평남겨죄송합니다...	메세지/의미
완벽했다..틸다 스윈튼은 신비롭고 아름답고 톰 히들스턴은 조니뎁이 떠올랐다..음악좋고 메시지도 좋고~	메세지/의미
현대 사회의 인터넷에 대한 영화의 주제 의식은 의미가 있지만, 범인 및 피해자 설정과 범인을 쫓는 과정 등 나머지 것들은 그저 그런 수준이다.	메세지/의미
지극히 단순한 의미를 전달하기 위해 지극히 지루한 방법으로 풀어나간 영화, 관객의 시간을 낭비하게 만든 영화	메세지/의미
엉성하고 뻔한 스토리에, 배우들은 발연기. 내용도 재미도 의미도 아무것도 없다. 관객과 영화가 따로 논다. 공감이 전혀 안가더라. 이 영화가 이스라엘영화의 전부는 아니겠지만 그래도 이스라엘 영화는 다시는 보지않겠다. 이런 걸 왜 수입한 거냐 도대체..	메세지/의미
시원찮아보이지만 꽤 심오한내용을 다루고잇네요.... 겉으로보기보다는 내용안에 의미를 잘 이해하면서 봐야할듯하네요...	메세지/의미
거짓이 진실보다 위대해 보이는 영화. 그 거짓속에 담긴 메세지만 보더라도 별10개가 아깝지 않다!	메세지/의미
슬프도록 저평가된 마스터피스. 겨울왕국보다는 당연히 낫고 솔직히 오늘 보고온 인사이드 아웃보다도 더 잘만들었는데? 조만간 후속편 나온다고 하는데 그때는 제발 제목 변경한번 검토해보고 꼭 국내더빙버젼에는 의미없는 연예인 더OO키지말고 전문성우를 쓰도록.	메세지/의미
메릴 스트립 출연 영화라서 봤는데 정말 연기가 후덜덜하네요. 다른 배우들도 그렇고 대단합니다. 주인공 수녀가 자신의 사고의 틀 안에서 가진 확신,믿음이 의문으로 전환되면서 흘리는 눈물. 참 의미가 있는 것이네요.	메세지/의미
2001년 영화라고 보기엔 매우 혁신적이고 스토리도 탄탄하다. 긴장감도 좋고 메세지도 남는편..	메세지/의미
정말 좋은 영화네요! 흑인이 검사나 시장 같은 고위직책에 앉으면 세상이 어떻게 망해가는지를 보여줍니다. 그렇죠, 흑인은 노예죠. 노예란 의사가 통하는 진보된 가축이란 것 정도의 의미죠. 그런 흑인들이 사회에 진출하다니... ㅉㅉ 정말 좋은 영화네요^^	메세지/의미
액션만이 아닌 그 속에서의 심도 있는 전쟁의 메시지를 담고 있는 것 같습니다.	메세지/의미
집중을 해서 보더라도 놓치고 당한다.. 의미를 알았을땐 감탄.	메세지/의미
영화를 안보다가 간만에 한편 봤네요. 레옹같은 감성이 느껴지는 영화.. 오락영화에서 의미를 찾는 것이 더 웃긴 건지도 모르지요. 가볍게 보기 좋은 영화.. 한표 던집니다.	메세지/의미
"""종교영화에 대해 관심도 없고 종교에 대해 관심이 없어서 그저그렇고 대부분 아카데미 영화 수상작은 지루함과 너무 의미적이고 상투적이라 재미가 없었다. 하지만 이 영화는 종교에 대해 자연스럽게 보여주고 중간 쯤 부터는 마치 """"죄와벌""""을 보는듯한 느낌이다."""	메세지/의미
권상우, 김하늘, 공유 출연 영화는 글쎄. 이런 영화가 480만 관객을 동원했다니 믿을 수가 없음. 정우의 깜짝 양아치 출연도 별 의미 없음. 이 영화가 2003년 작품이라니. 특히 이 작품에선 김하늘 못 생겨 보임	메세지/의미
1점 짜리 영화는 아니지만 9.35점 짜리 영화는 아님. 잃어버린 핵심 메세지	메세지/의미
난 이 영화 지루했다. 나에게는 큰 메세지도 없었고, 일단 그 메세지가 아무리 좋아도 영화가 재미없으면 전달이 안된다. 거장이고 뭐고 간에 너무 지루하다.	메세지/의미
참신한 소재..의미심장한 내용..	메세지/의미
흥행하지못한작품후속작을왜만들었을까,의미없는살인물.괜히긴런닝타임.다봐서3점준다	메세지/의미
두번봤는데 개봉할때 어제. 마지막에 독일군이 그냥 간건 독일내에서 전투를 벌이고 있다는건 패망전 한두달전이다. 이미 그때는 전쟁에 염증을 느끼는 독일군들이 많았다 오죽하면 롬멜 조차도 반란으로 처형되었을까. 그냥 의미가 없음을 느꼈겠지.	메세지/의미
왜이렇게 평점이 낮은지 모르겠다 ㅠ 난 너무 마음아프게 봤고 전쟁의 참혹성과 무의미함,슬픔 등 여러가지를 느낄 수 있었다.여러 시점으로 전쟁의 상처를 느낄 수 있었다.그렇기에 그들의 행동이 더 슬프고 이해가 됬다. 영화 속 그누구도 탓할 수 없었다	메세지/의미
영화에서 전달하고자 하는 메세지가 마지막 반전을 통해 너무나도 강력하게 전달됐다. 케빈 스페이시 출연작중 최고 작품.	메세지/의미
스토리도 그렇고, 대사도 그렇고,, 의미를 부여할려고 해도 너무 별로 인 것 같네요.	메세지/의미
네이버 평점이 잘못되었음을 뼈져리게 느낀작품. 참신함도 없고 메세지도 없고	메세지/의미
이 영화 보고 맥어보이 팬이 됨. 영화 자체가 주는 메시지도 감동적임	메세지/의미
의미는 좋은데..재미가 없잖아...	메세지/의미
여러가지 의미에서 정말 자지러지게 웃기는 코미디	메세지/의미
로버트랑 우마서먼땜에라도 궁금해서 봤는데 이건뭐ㅋㅋㅋ평점10점이나 감명깊게봤다는 사람들 수준이 심히무섭네요 쓰레기가튼넘을 극미화시키고 여배우들로 좋게 포장한듯 보이나 감동도 메세지도없고..치명적인유혹?찌질하다못해 불쌍하기까지...	메세지/의미
'진정한 친구'의 의미를 알게 해주는 유쾌한 프랑스영화	메세지/의미
스토리. 캐릭터. 표현력. 영상미.	영상미
영상미. 한여자의 성장. 크리스마스	영상미
재미없어요 영상미는 쩌는데.. 편집이 그닥... 무슨내용인지 알게 짤라서 붙히든가	영상미
부르주아 특권층을 위한 작품,양민인 나로선 공감이 어렵군.영상미 하나는 맘에 든다;	영상미
연출과 영상미가 좋다 그게 다	영상미
자연환경, 배경음악, 영상미의 극치를 보여주는 너무나 아름다운 무협영화.	영상미
마지막 너무 먹먹하고 슬프네요 부모님 울때 ㅜㅜ 영상미가 신선하고 괜찮았지만 미야자키님이 은퇴작으로 이걸 했더라면;;; 왜 왜곡 영화 만들어서...; 막판에 욕을 먹는지;;; 쩝	영상미
오글거림 그 자체. 별로 이 영화에는 바라볼 매력이 없는거같다. 어색함 그 자체. 영상미는 좋더라.	영상미
영상은 볼만했으나 스토리가 영상미마저 허접스럽게 만듦 제작비가 아쉬운 영화	영상미
다양한 영상미를 넣은건 좋았지만 정말 루즈한 영화. 6-7점 줘도 무난하지만 9-10점 뿌리는 사람들 감안하면 4점이 적당함	영상미
이거 진심 재미없음 영상미는 트랜스포머수준인데 스토리는 이리로 갔다 저리로 갔다 여자주인공은 이리저리 끌려다니고 시간 버리고 싶으면 보는게 좋을듯	영상미
화려한 영상미와 스토리..	영상미
어른을 위한 동화슬럼프에 빠졌을 때 극복의 계기를 줄만 하다살면서 소중한 것을 다시 일깨워줌...영상미도 좋음	영상미
영상미가 뭐가 좋다는 건가요? 어지럽고 정신사납습니다. 그냥 성형으로 만들어진 여자가 몰락하는 영화에요.. 느끼는거 없고 내용도 평범하고... 평점왜케 높은지 모르겠네요..	영상미
실망감이 크다. 영상미가 어쩌구하는데 그 또한 1이 더 나았음.	영상미
연기력, 영상미 굿.	영상미
다니엘의 007은스카이폴>카지노로얄> 퀀텀 순인거같다..왜 퀀텀에선 영상미도없이 때려부수기에 바빴을까..	영상미
나는 불호.. 영상미는 인정하지만... 내용이 잔인하고 찝찝하고 짜증남..1점도 아까움	영상미
영화 제인에어와 비슷한 촬영방식.. 나중일을 첫 장면으로 보여주는것과같은.. 감독의 의도는 이해했으나, 냉정하게 말하자면 이렇게 밖에 풀수없었나 싶은 아쉬움이 남는다, 그러나 영상미는 좋았으므로 3점.	영상미
정말 영상부터 내용까지 너무 좋았다. 특히 영상미가 너무 아름답고 색감이 너무 예쁨... 내용도 배우들도 연기도 다 퍼펙트. 다시 보고 싶은 영화. 마지막에 여운이 남는 영화.	영상미
여백의 영상미 감성 내용 등 어느하나 아름답지 않은 것이 없었던 듯..	영상미
90년대 멜로 영화들 보다 영상미가 더 낙후된 듯한 느낌..	영상미
모지 평점이 왤케 높아.. 그냥 영상미만 있고 아무것도 남는게 없음.. 억지반전..	영상미
반전있는 스토리에 영상미까지~♡	영상미
10화 대박 특히 엔딩씬 광해 임해 표정연기 ㄷㄷ눈오는 밤 영상미까지 다음회 기다려지는 드라마 오랜만임	영상미
영상미는 정말 ㅋㅋㅋㅋㅋ	영상미
영상미가 좋아 추가 1점 획득!	영상미
네티즌 평점 믿지마셈. 진짜 영상미 뛰어나고 예쁜영화임. 난 두번봤음. 영화자체가 한 폭의 그림같음. 여운도 남고 연기자들 연기도 훌륭함. 단언컨데 사극멜로 중 최고.	영상미
영화에서 뭔말을 하고 싶은지는 알겠는데 화면 구성력이나 영상미가 이리도 맥아리가 없나.... 보는내내 색감만 쨍할뿐 시들시들한 느낌이었다. 너무나 엉성해서 치가 떨린다...	영상미
극장에서 봤지만 영상미와 스토리 모두 내가 본 영화들중 최악이라고 자부할 수 있다.	영상미
이제보니 더빙이 빵빵하네 ... 두 소년은 우정을 넘어서 서로에겐 없어선 안될존재!!! 게이? ㄷㄷ ㅎ 영상미 하난 끝내줌...	영상미
영화는 영상미로만 완성되는게 아니다	영상미
초반엔 찬란한 색감의 아름다움에 넋을 놨다 중반엔 이야기가 가지고 있는 감정변화에 따른 영상미에 벅찼다 그리고 후반엔 끔찍한 슬픔과 공허함에 씁쓸했다 흥미로운 영화다	영상미
화려한 영상미와 줄거리 모두 만족스러운 영화	영상미
아름다운 영상미와 아름다운 여배우....	영상미
지금봐도 뛰어난 영상미....훌륭합니다!!	영상미
진짜 강추.... 영상미도 엄청 예쁨...ㅠㅜ	영상미
음.. 더빙판은 비추고요 외국배우 더빙으로 보시는걸 추천합니다. 아름답고 화려한 영상미에 스토리 짜임새도 훌륭합니다.	영상미
박해일,김혜수 연기 너무 좋았어요ㅠㅠㅠ진짜 영상미도 짱..	영상미
리들리 스콧의 영상미학과 한스 짐머의 음악... 후까란 바로 이런 것이다.	영상미
문학을 빌려 광활하고 장대한 영상미와 함께 영화적인 어떤 힘을 보여주지만 무엇보다 무의식이나 심연속의 고귀하고 잔인한 본성과 욕망을 꿈이나 횐상처럼 보여준다.. 감독의 성장배경에서 기인했을 러시아적인 시선을 경험하게 된다 광대하면서도 그만큼 공허한..	영상미
의미있는 영화다. 재미 의미 영상미	영상미
영상미만 있어요. 참신하게 폭망한 듯	영상미
가만있다 정말 이유 없이 불현듯 떠오른 '가을동화'. 보고싶어졌습니다. 전편을 이틀만에 봤습니다. 크헉크헉 울면서... 다시 봐도 명작입니다. 영상미, 배경들 미치도록 아름답네요. 두고두고 가슴에 남을 거예요. 아... 아리고 아린 드라마. 가을동화	영상미
주원, 황찬성 캐스팅 괜춘 (+2점) 주원 연기 괜춘 (+1점) 최강희 캐스팅 미스. 황찬성 연기 아쉬움. 소재 아쉬움. 시나리오 아쉬움. 연출 아쉬움. 영상미 아쉬움	영상미
영상미가 돋보인다고 할까... 스토리를 떠나서 감독의 다음 영화가 궁금해지네요.	영상미
감독이 게이라 그런지 영상미는 좋았으나, 결국 겉멋만 든 영화인듯. 페북 프로필에 허세용으로 올려놓기 좋은 영화. 웬만하면 보지말자 시간이 아깝다	영상미
멋진 OST와 회색빛 도시의 영상미... 감동.. 감동..	영상미
재밌네용~~ 야하기만하고 내용은별거없는허접한영화도많은데 내용도탄탄하고 몰입해서잘봤어요 다른부분도다훌륭하지만 연기력 음악 영상미 굿굿	영상미
영상미 만점, 상상력 만점, 그러나 뭔가 연개가 부족한 느낌 8점..	영상미
영상미 , OST , 스토리 모두 좋았다.	영상미
재밌네요 르네 젤위거가 이쁘게 나오고 영상미도 좋고	영상미
더욱 커진 스케일 화려해진 영상미 환상적인 춤! 시리즈중 가장 좋았다.	영상미
엉성한 연출, 허접한 CG, 독립영화보다 못한 영상미, 예쁜 척만 하려는 황효명과 판빙빙의 연기에 두 손 두 발 다 들게 만 든 영화.	영상미
현빈 성유리 정말 최고의 캐스팅이었다. 특히 성유리가 미모의 끝을 보여줬지. 내용도 너무 슬프고, ost 러브홀릭이 부른 메아리도 너무 좋고. 영상미가 영화급이었던 판타스틱한 드라마.	영상미
정말 아름다운 영상미. 그리고 깔끔한 이야기	영상미
평점이 너무 낮아서 10점줌 솔직히 1~2점 줄 영화는 아니지 달달하게 잘 그렸구만 연기도 잘하고 영상미도 좋고 상황 설명도 친절하고 간혹 어렵다는분들있는데 범인이라도 찾으시나?	영상미
몽환적인 영상미와 미장센은 일품이고, 발상과 플롯도 독특하면서 짜임새있다.	영상미
뛰어난 영상미와 훌륭한 서사 특히 영상적 연출에서는 정말 경의를 표할 수 밖에 없다.	영상미
흥미로운 스토리, 탁월한 영상미. 아!주! 세련됐다.	영상미
찌르고 베고 자르고 피 좔좔...이런게 멋있는 영상미는 아니지. 죽음과 시체들 밖에 기억에 안 난다	영상미
남녀배우들의 연기가 어색하기 짝이없었음 첫사랑의 풋풋함과 가슴아픈 첫사랑의 아련함을 믹스하려다 실패한듯한? 초반부보다 후반부의 영상미가 뛰어났다는건 각인시킨 듯. 후반부 영상미덕에 1점 더줌	영상미
시청률로 평가하기엔 너무나 멋진 드라마.한편의 영화를 보는 듯한 영상미와 배우들의 초절정 연기력 모든 것이 완벽했다.진정 시청자로서는 행복한 시간들 이였다. 아시겠습니까?	영상미
화려한 영상미와 재치있는 연출때문에 하나도 지루하지않았다. 이걸 극장에서 봤어야되는데 이제야 본게 아쉽다..마지막 장면은 정말 감동적이였다..여운이 오래남을듯	영상미
좀 난잠한 감이 있지만 주제의식도,표현기법도 좋은 작품.영상미 또한 최고	영상미
불필요하고 산만한 등장인물들이 많아서 오히려 감동반감. 밋밋하고 지루한 영상미.	영상미
철두철미하게 자기만의 이기적인 성찰을 음미하게해주는 영상미에 반했어요	영상미
영상미가 너무 이쁘다. 7년 후에 봐도 촌스럽 않고가끔 대사가 유치하더라도 가슴 먹먹한 드라마	영상미
가끔 일일연속극 찍으셔야 할 분들이 영화를 만드는 일이 있는데 이 영화가 그렇다. 종교적 알레고리를 빼면 지리멸렬한 내용의 연속일뿐. 영상미도, 페이소스도, 멋진 대사도 없다. 3년동안 레고를 조립해봐야 레고밖에 더 나오나. 영화라는 장르에 대한 모독	영상미
명품 연기에 예쁜 영상미...제가 딱 좋아하는 감성영화 였어요 감사합니다 잘 봤습니다	영상미
영상미가 예쁘고 신비로웠던 영화. 멋졌었어요. 기억난다. !	영상미
영화의 시나리오와 전체적인 영상미와 배경음악... 모두 마음에 들었습니다...	영상미
영화채널에서 우연히 봤는데, 신선하고 영상미도 좋았고 재밌었네요!!	영상미
영상미 아름답고 주인공의 사랑이 순수하고 풋풋하다. 한 번 더 보고싶은 영화!	영상미
하나줄려다 음악땜에 두개준다..화려한 영상미? 과해.. 과하다구!! 스토리도 없는 주제에;	영상미
한 시간 안에 이런 감동과 여운을 줄 수 있다니! 초속 5cm 때도 그랬고 언어의 정원 역시 기대를 저버리지 않았다. 영상미와 음악, 내용 전개 및 연출까지 지극히 훌륭하다.	영상미
이런 드라마가 많이 나왔으면 좋겠어요. 생각할 것도 많고 영상미도 아름답고 캐릭터도 다 매력 있었어요. 여러가지로 다 매력 있었던 드라마였어요.	영상미
기분나쁨과 자유 사랑이 뒤섞어져 나는 다시보고싶지도 이해하고싶지도 않음 ..아름답지않은 내용과 아름다운 틸다스윈튼 미장센 영상미로 만들어진 영화인듯..	영상미
스콧 감독의 전작 명성에 미치지 못한건 사실인듯 하나, 그렇다고 너무 저평가받을 작품은 아닌 것 같다. 람세스역이 좀 아쉽긴 해도 대규모의 영상미는 정말 명불허전이었다.	영상미
단순한 스토리를 영상미로 덮다	영상미
1점도 아까워서 리뷰 안달려고 했는데 이 영화 개쓰ㅡ레기임. 화질이나 영상미도 핵폐기물임. 차라리 바퀴벌레세포 움직이는거 5시간보는게 더 의미있구여.제가 이영화 골라서 친구들이랑 봤는데 시이ㅡ발 그 뒤로 친구들한테.저렴한년, 프리티걸이라고 갈궈졌습니다	영상미
이 영화를 보면 영감이 떠 오른다 영상미도 좋다.	영상미
영상미영상미 그러는데 그렇담 서스펜서 스릴러라는 말로 사람 기대시키지말자	영상미
쓰레기영화.어줍잖은 영상미와 폼과 허세만 가득한..	영상미
조금은 촌스러운것 같으면서도 세련된 영상미에 웬지 모를 향수를 느꼈다.	영상미
스토리도 좋고 영상미에 인물들의 카리스마까지 10만점이다. 재미있다-	영상미
아이들의 내면 심리묘사가 뛰어나고 70년대 시골풍경의 영상미가 뛰어난 수작!!	영상미
열혈, 중경, 화양연화로 거장의 반열에 오르는가 싶더니 2046 이후 영상미만을 강조한, 자신 혼자 즐기는 미장센으로 내리막길에 접어든 감독인듯 하다. 영춘권, 엽문, 그 이름만으로도 기대가 되지만 보여주는 것은 × 와호장룡이 얼마나 대단한 영화였는지	영상미
몇 편의 영상미는 좋았다	영상미
1977년에 만들어졌다는 게 믿기지 않을 정도로 특수효과와 영상미가 뛰어났다. 게다가 결말을 미리 알고 있었음에도 영화 끝부분의 비행전투씬은 굉장히 긴장하면서 보았다.	영상미
1편의 작품성을 완전히 망가뜨린 삼류영화...영상미 빼면 시체	영상미
수려한 영상미로 전달하는 한편의 소설같은 느낌을 주는 애니. 전작이 다소 실망스러웠던 만큼 이번작품에선 상당히 발전한 연출과 스토리텔링이 돋보이는듯.	영상미
개연성 엉망에 신세경 머리는 짧아졌다 길어졌다가..말도 안되는 억지설정에 급작스러운 결말.. 기억에 남는 거는 푸른빛 도는 영상미와 어딘가 모르게 설레는 송강호 뿐...	영상미
음악이나 영상미 외엔 아무 느낌 없다.	영상미
EBS년말 방송분에 대해 초반과 결말 부분이 덜 녹화된 상태로 봄. 남녀간의 사랑과 사회 부조리에 눈뜨고 따뜻한 인간애를 가진 베트남 왕실 혈통의 남녀가 어떻게 시대상황에서 삶을 개척하고 대처 적응해가는지를 아름다운 영상미를 바탕으로 표현한 수작	영상미
예수님의 탄생을 과장없이 잔잔하게 잘 담아낸 영화크리스마스의 의미를 다시 생각해볼수있었던것같습니다.담담하게 자신의 사명인 아기예수님의 탄생을 준비하는 요셉,마리아가 인상적입니다.ㅠㅠ^^영화영상미가 너무 예뻐요..특히 마굿간 빛이 비칠때 .ㄷㄷ..	영상미
평점 왜이렇게 낮지 영상미 최고 내용도 신선하고 좋았다	영상미
훌륭했다. 미지의 환경에 대한 호기심과 두려움을 잘 담아냈다. 블랙박스를 확인하는 듯한 촬영기법 또한 좋았다. 갇혀있는 우주선 안에서 배우들의 연기로만으로 승부해야하는 영화였는데도 잘 풀어낸 느낌이다.	영상미
영상미나 연출이 전체적으로 나쁘진 않지만 문제는 이야기가 굉장히 지루하고 쓸데없이 길다. 고질라가 알고보니 착한편이라는 반전 아닌 반전도 영화 초반부에 다 설명을 해버리니 그저 고질라가 언제 이기나 기다리는 것도 고역이 아닐 수 없다.	영상미
잔잔하면서도 영상미 참 아름답다. 보면서 너무 따뜻하고 시원했어요.	영상미
괜찮았습니다. 만 오랜 촬영기법이 조금 씁쓸하긴 합니다.	영상미
개연성이 아예없음 스토리진행이 지꼴리는대로임 과학적오류가 넘치다못해서 토할지경 엄청나게신선한 소재와 엄청나게나름다운 영상미를 스토리로 조져버린 대표적인영화	영상미
1점 줄려다 영상미와 음악이 좋아서 3점... 이건 소설과 비교해서 영화가 구린게 아니라 그냥 영화자체만 놓고 봤을때도 망작이다. 영화를 한번보기시작하면 어떻게라도 끝까지보고마는 내가 밉다..	영상미
영상미만 아름다울뿐, 어설픈 연기력은 몰입력을 떨어뜨린다.	영상미
어렸을때봐서 몰랐는데 다시보니 너무 슬픈영화.10년전 영화인데도 영상미가 너무 예쁘다	영상미
빠른 전개와 영상미...배우들의 연기 뭐 하나 빠질것없이 잘만든 드라마네요.단지 편집이 조금...ㅎ그것도 곧 좋아질거라 생각됩니다3회 더 기대됩니다^^	영상미
객관적을 판단할 때는 스토리가 진부할 수 있겠는데, 일단 카메카 각과 영상미가 돋보인 영화입니다. 러시아영화가 이랬나에서 현재 러시아 이정도인가? 라는 사회상도 비추기까지 하구요~무엇보다 현실에서 갈구하는 부분에 대해 잘 찝어준거 같아요~ 추천!!	영상미
영상미가 많이 죽었다. 시리즈가 지나갈수록 스토리를 떠나서 보여지는 시각적 재미가 많이 떨어진다. 솔직히 시즌 2까지는 나름 기발했는데 시즌3는 내용이 묻힐만큼 영상미가 나쁘다. 단순히 킬링타임용이다. 후속작은 기대를 안하는게 좋다	영상미
어렵지만 아름답고 기괴한 영상미에 숨이 막히다. 대단한 영화임에는 틀림없다.	영상미
평점 조절. 고지식한 늙은이의 설교를 듣는 영화다. 영상미는 예쁘지만 단지 그 뿐.	영상미
아름다운 영상미, 애절한 OST, 잔잔한 감동의 대작드라마..	영상미
영상미, 음악 너무 좋습니다.. 다이안 레인 너무 아름답네요..	영상미
실화라니까 내용에 관해 욕하진않는다. 자극적인 사실이 다고, 영상미도 없는 영화다	영상미
왜 이렇게 좋은 영화가 6점대 인지 이해할수가없다. 좋은 영상미 배우들의 시선처리, 연기력 뭐하나 따질것이없는 연출인데..	영상미
영상미 같은 소리하고 있네 영상기법땜에 눈알 아픔..정신없고 산만하기만 하고 내용이 뭐 글케 재밌는 것도 아닌 뻔한 내용 뭐보고 명작이라 하는지 모르겠다. 액션도 하나도 없고 뭘 보고 진리다 뭐다 하는지 참..	영상미
서인국 감정연기가 좋음 이성재의 카리스마 넘치는 모습도 압권이고 남장했는데도 조윤희는 왜이렇게 예쁜지;; 스토리도 좋고 영상미가 예술bbb	영상미
일본 B급 영화의 대부 미이케 다카시 감독의 사무라이 액션. 13인의 자객보다 뛰어난 영상미는 압권이지만...	영상미
영상미와 음향미가 완벽히 조화된 대작..	영상미
9점 주려고했는데 생각보다 평점이 낮네... 영상미 보는 맛으로라도 즐길 수 있는 영화	영상미
1.쓰잘데기 없는 대사가 없다 2.영상미 압권이다 3.배우들의 연기력이 압도적이다	영상미
평점 높여 드릴게요 자단 형님! 이 영화 독특합니다. 금성무도 배역에 딱! 중국 고유의 풍광을 좋아하는데 이 영화가 제게 기쁨을 주었네요. 견자단 때문에 본 건데 영상미가 딱 내가 좋아하는 비주얼.	영상미
시간아까운 개똥영화 ..안보는게 나아요.. 개망작임....촬영기법은 난잡하고 스토리는 진부하고 볼거리라곤 고어적인 부분 끝...	영상미
감독이 뭔 얘기를 전달하려는지는 잘은 모르나 은근히 영상미도 있고 남녀 주인공도 괜찮고 재밌었다.	영상미
영상미 하나만으로도 별 1000개는 주고싶다 어떻게 이렇게 찍을수가 있지	영상미
영상미와 음악 그리고 연기자들에 연기력이 살린영화 라는 생각입니다. 좋은영화인건 확실하구요. 아쉽다면 내용의 마무리진행 부분에 대한 아쉬움이 개인적으로 남지만 그정도는 눈감아 줄수 있습니다^^~	영상미
개인적으로 정말 괜찮게 본 영화다. 영상미,음악,분위기 모두 좋았고 내 스타일이라서 더 재밌게 본것같다	영상미
수작인지는 모르겠으나, 영상미/분위기/흐름이 좋았다.	영상미
아름다운 영상미와 매우 훌륭한 내용 특히 OST는 희대의 걸작..	영상미
진짜 명작이다 연기력과 영상미가 어우러져 감동을 준다	영상미
촬영기법이 제일 아쉬운 영화였다. 내용이나 연기는 좋았지만,	영상미
재미도 없고 영상미도없고 이쁜여자도 없고 ㅉㅉ	영상미
영상미갑 123123	영상미
영상미에선 단연최고.한편의 cf를 보는듯한.이소연 연기에 굿^^	영상미
영상미와 배우들의 비쥬얼, 연기력은 정말 좋다 말할 수 있지만, 저 여자의 사랑의 방식은 정말 이기적이다. 또한 이런 사랑을 보며 아름답다고 말하는 사람들은 그렇게 이기적인 사람이 아닌가 생각될 수 밖에 없다. 중간에 팀과 결혼만 없었다면..	영상미
영상미는 좋지만 스토리 연결이 너무 부실합니다	영상미
의외로 괜찮았어요. 다만 해석을보지않으면 이해하기 난해한점이 아쉬웠네요. 영상미, 연기력, 소재등이 좋았어요.	영상미
에바그린과 우들리가 넘 이뻤다 기타 영상미와 색감만큼은 최고 근데 전개가 영.. 마지막 반전은 4류 드라마 스럽다...	영상미
개봉한관이 별로없어서 멀리혼자 보러갔는데, 후회하나없이 백점! 음악, 영상미, 내용은뭐 노멀했지만 감성적인부분 다 좋았다.	영상미
잔잔한 감동 스토리와 배우들의 연기도 좋았고, 영상미가 압도적인 영화.	영상미
1946년 작품이다. 진짜 대단한 작품이다. 지금봐도 OST, 영상미, 연출력... 대단하다.	영상미
장점: 상큼발랄 여고생활 잘 묘사/ 교환일기장- 참신/ 감성적 영상미, BGM/ 알싸한 우윳빛 공포영화 개척 시도 단점: 광기어린 레즈, 남교사와 썸- 3류영화틱/ 애들 가둬놓고 유세떨다 가는 귀신-결말 어정쩡, 공포 밋밋/ 상상-현실&과거-현재 혼선	영상미
최고다. 영상미+연기	영상미
20대 성인이되어가는 과정에서 보게되어.. 알렉산드리아의 입장에서 영화를 봤던 것 같다. 스토리도 영상미도, 배우들도 다 정말 좋았다.	영상미
영상미 음악 모두 마음에 꼭 드는 영화	영상미
쿠엔티 타란티노 킬빌 이후에 가장 영상미가 좋았어요 특히 설원위에서 신은 멋지더군요	영상미
시나리오, 영상미, 배우의 연기 어느 하나 흠잡을 수 없다.	영상미
이거 일본영화 맞음? ㅋㅋㅋ 액션 지리네 솔직히 좀 유치하지 않을까 걱정했거든 만화가 원작이라 근데 그 가벼움을 액션으로 영상미로 모든게 커버했다 와 ㅋㅋ 일본영화 아닌줄알았음 ㅋㅋㅋ	영상미
예술의 경지에 도달한 애니메이션 영상미에 한번 놀라고 서사에 한번 더 놀란다.	영상미
이게 왜 이렇게 평점이 높은지 모르겠다. 특이함과 영상미에만 취해있기엔 너무 알맹이가 없는 느낌	영상미
영상미좋고..액션도 괜찮음...오랜만에 다시 보니까 좋네요	영상미
TV 다큐로 보고 영상미, 스토리에 감동먹었는데 이제는 못 보나요? 어디서 볼 수 있나요?	영상미
솔직히 너무 실망했습니다. 올해의 맘마미아라는 홍보문구를 보고 기대를 하고 갔는데, 보고난 후 맘마미아를 대체 어디에다가 붙여놓은건지... 화가나네요...화려하고 다양한 음악과 영상미를 기대하시는 분들은 보지마세요.. 소소한 가족얘기입니다..	영상미
진부함의 극치. 뛰어난 영상미가 이를 보완하지만 9점이 넘는 점수는 어불성설 개인적인 평점은 7점 정도라 생각하지만 평점 조절용으로 1점 준다.	영상미
배우들 연기도 서툴고,,,전달하고자 하는 메세지도 없고,,영상미? 유치한 화면 구성. 네이버 평점은 알바 천국인듯.	영상미
영상미가 역시 최고네요	영상미
기쁨, 슬픔, 생명 그리고 죽음. 인간의 역사속에 거대한 하나님의 우주적 섭리가 느껴지는 영화. 특별히 어머니의 역을 맡은 여배우의 여성미와 자애로움이 인상적이다. 인생을 살면서 그런 존재가 된다면. 영상미 예술이다!	영상미
불륜을 미화한 영화 남은사람들은 어쩌라고 또 돈걱정 따위 안하는 사람들의 이야기를 공감하라고 강요하는 영화 음악이랑 영상미로 3점	영상미
영상미 예쁘고 좋지만 러닝타임이 2시간이 넘는데 초반 30분에 줄거리 다 나갔고 엄청 지루한 화보집 보는 기분 일본영화 특유의 그 이해못할 희한함이 있음	영상미
옛날영화의영상미 외엔 장진영 엄청난 흡연량을 요구하는 것만 기억나는 영화	영상미
영상미도 훌륭하고 배우들의 연기도 나쁘지 않지만 거지같은 각본과 늘어지는 편집과 허접한 연출력은 이 영화를 쓰레기로 만들었다. 결말도 최악.	영상미
엄청난 여운, 하나도 빼놓을수 없는 영상미, 따뜻하다.	영상미
그냥 영상미하고 배경을 잘만들었는데 역시인간의타락주된모습일뿐 그냥그이상으로 스토리는별로입니다.	영상미
영상미랑 내용이랑 다 괜찮았다!	영상미
화려한 영상미를 뽐내는 현대판 천녀유혼! 아주 잘봤습니다. 매우만족!	영상미
스토리와 영상미의 완벽한 조화	영상미
[ 스토리 10, 비주얼 10, 연출 10, 연기 9 ] 역사상 가장 위대한 판타지의 서막. 영상미와 캐릭터에 취해 지루할 틈이 없다.	영상미
강우석의 망작 중 하나. 영상미는 열심히 찍은듯 하다	영상미
영상미도 아름답고, 힐링되는 영화. 개인적으론 1편이 더 맘에 들지만. 음악도 좋다.	영상미
이건 심했지.. 미녀가 갑자기 야수을 급사랑하질 않나.. ㅋㅋㅋㅋ 영상미만 좋음	영상미
봐도 봐도 명작이다. 음악부터 영상미, 배우들의 명연기..나쁜 인간들은 그렇게 잘사는데 죄없는 사람들은 왜 그렇게 일찍 갈까..	영상미
장엄하고 엄숙한 연출과 영상미. 역시 리들리 스콧이다.	영상미
중간에 영상미가 뛰어난 장면이 좀 나오는지는 모르겠지만 영화라는게 초반부터 확 끌어당기는 흥미진진함이 있어야 하는데 너무 잔잔하기만 하고 드럽게 지루하다. OST가 아깝다. 잔잔하고 잔잔해서 러닝타임이 다섯시간은 되는줄 알았다.	영상미
영상미,등장인물다 좋았다.레이첼 연기는 잘하는데 악역은 안어울리는 듯 ㅋ	영상미
음악 영상미 둘다 최고 감동까지 ㅠ.ㅠ	영상미
본 로맨스 영화의 남녀이야기중 가장 가슴떨렸던.. 그리고 가장 아름다웠다고 생각될만한 영화였어요. 여주인공의 미소는 여자가 봐도 반할정도 .. 거기에 멋진 영상미까지 단지 아쉬웠던건 후반부?	영상미
잔잔한 영상미 자비에돌란 완전 귀여움	영상미
아름다운 계곡 영상미와 긴박감이 잘 어우러진 수작!	영상미
와 정말 어떻게 이렇게 못만들수가 있는지 깜짝놀랐다. 영상미??매력적?? 개뿔! 강동원 팬이라서 봤지만 장면들이 다 개연성도 없고 장면들이 이어지는 부분들도 남들은 절대 안쓸 기괴한 테크닉만 써서 짜증난다. 줄거리도 이해 안되고 연기도 과장스럽다.	영상미
고결해보이기까지 하는 공리의 미모와 화려한 영상미만으로도 10점 충분히 주고도 남는다.	영상미
영상미까지 담으려했구나 ㅋ	영상미
아 진짜 머랄까 영화촬영기법이나 표현방법 그런것들이 매우 신선했다. 마지막에 총알을 녹이는 장면이 매우 인상깊다	영상미
제목과 무관,영상미와 편집이 대박.포르노를기대한다면 꺼지삼.	영상미
촌빨날리는 영상미와 그 어색한 연출	영상미
무각본으로 이루어진 리얼한 연기, 한장면도 빼놓을 수 없는 예쁜 영상미.	영상미
다시 이 조합 보고싶당! ㅋㅋㅋ 영상미 짱	영상미
뛰어난 각본 및 구성. 흑백의 영상미. Le monde est a nous	영상미
잔잔하지만, 영상미도 좋고 감동도 있다. 다시보고 싶네.	영상미
영상미는 있는데 아빠와 딸의 사이같은 남주와 여주 때문에 소름돋았다.. 감독이 우디앨런이라 그런가 ㄷㄷㄷ	영상미
지인의 추천으로 본 영화입니다. 영상미도 음악도, 스토리도 탄탄하니 좋았습니다. 오랫동안 기억에 남을 영화.	영상미
짧은 러닝타임.. 짧아서 더 여운이남고 영상미와 음악까지 모두 굳..	영상미
어린이용 만화 감안 내용 너무 유치하고 재미없고 영상미도 별로다	영상미
그림 영상미 bgm 모든게 좋았던! 작업하는 모습이 정말 푹 빠져들게 했어요	영상미
진부하지 않은 러브스토리. 영상미도 좋고 음악도 좋고 전반적으로 특색있는 영화입니다.	영상미
영상미, 음악은 정말 괜찮아요. 이거 하나로 볼 만한 영화임. 말도 안되는 어른 여자의 판타지 소설이지만;	영상미
러닝타임내내 미술관에 온 것같았고 내가 마치 숲속안 르누아르의 집 안에 함께 하는 것 같다고 생각할 만큼 집중도 높은 영화였다.영상미 자체는 이루 말할 데 없이 훌륭하였고 잔잔한 분위기로 숨죽여 볼 수 있게 만든 구성도 완벽했다	영상미
영상미가 아주 멋진 영화. 스토리는 그냥 그랬지만 영상미가 압도적이었기에 만점드립니다.	영상미
뛰어난 영상미. 기발한 상상력. 보고난 후엔 숨통을 밧줄로 옭아맨 기분. 슬프다...	영상미
일본영화 특유의 잔잔함..빠져들고 싶은 영상미 마음에 평안이 온다	영상미
정말 영상미넘치고 잔잔하고 아름다운영화 간만에 좋은영화봤네요ㅠㅠ	영상미
영상미와 아름다운 사운드트랙. 풍부한 감수성과 시적 아름다움. 터부에의 도전.	영상미
음악이 주가 된, 최고의 음악영화	영화음악
마음이1을보신분들은 이해하시겟지만 2는망장입니다 졸작이죠 솔직히말해선;; 그이유는 예를들면 엽기적인그녀는 긴시간을두고 코메디 멜로를 그렷습니다 하지만 이영화는 단시간 10분안에 모든것을 소화하려는 욕심 코믹하다 3분채안돼갑자기 생뚱맞게 슬픈음악이깔리고	영화음악
실제 사실은 어땠는지 모르겠으나 의로운 협객으로서 김두한이 거지패에서 종로 최고의 주먹으로 평정하는 초기 모습을 잘 보여 줌. 배경음악이 영상과 잘 어울린다는 느낌. 참고로 황정민이 우미관 지배인으로 나와서 유명하기도 한 영화.	영화음악
정말 가슴아픈영화....질리지도 않는영화....몇번을봐도...음악도 너무 좋아요...OST도 구해 들었다는...	영화음악
재미있습니다...ㅋ 좀 황당하고 유머러스하고 엉뚱하지만 유쾌하게 보았네요~ 더불어 음악도 좋았습니다~^^	영화음악
수채화같은 영상과 가슴을 울리는 음악이 조화된 잊지못할 명작	영화음악
잔잔한 음악과 후반부에서 큰 재미를 드러내는 영화. 좋다^^	영화음악
음악 쌤이 보여줬는데 진짜 짱인 영화	영화음악
두 부자가 겪는 사랑의 조심스런 시작에 관한 마이크 밀스 감독의 섬세한 터치. 주인공들과 강아지 아서까지 모든 캐릭터와 음악과 삽화들과 교차편집까지 이토록 예쁘고 사랑스러울 수 있을까. 다운받아 수시로 틀어본다.	영화음악
흑인음악이 왜 soul인지 알수있을거같다..	영화음악
이제서야 보게되었네요.늦은밤 미소와 안타까움에 마음이 찌릿했습니다.사랑이란 감정은 하나로 정의되는것이 아니며늘 다른 모습으로 곁에 있는 것 같습니다.한가지 아쉬운점은 슬픈장면에서 나오는 음악이 너무 반복되네요ㅋ몰입 약간 방해. .	영화음악
소재만 신비롭지...영상, 내용 그리고 배경음악 등이 왜이리도 촌스럽고 허접하게만 보이고 느껴지던지...	영화음악
좋았어요연기, 음악 모두... 춤도 볼만하고보아 연기도 괜찮았어요	영화음악
음악, 영상은 좋지만- 여주인공의 성격과 스토리의 개연성 부족. 기독교인에게는 추천	영화음악
스텝업1을 많이 따라한감이 있지만 좋은 음악과 춤 좋은 헤피엔딩이다.	영화음악
밥대런 그의 음악에 울고 그의 일생에 울었다. 아... 이게 실화라니...	영화음악
자연환경, 배경음악, 영상미의 극치를 보여주는 너무나 아름다운 무협영화.	영화음악
여태껏본백설공주이야기중가장현실적이고슬펐다스페인특유의분위기와스토리가음악으로잘표현되어서눈과귀가즐거웠다	영화음악
매력적인 배우들과 매력적인 음악. 아 아름답지.	영화음악
음악에 무지한 내가 봐도 감동적인 영화임 ㅠㅠ	영화음악
뒤로 갈수록 개판, 추억의 록음악땜에 별두개	영화음악
갇동과 웃음이 있네요 음악도 좋았구요 로빈 너무 귀여워요 ^^	영화음악
아이들이 보기에 너무 좋은 컨텐츠인것 같아요. 캐릭터와 드라마, 중간중간 지루하지 않게 음악까지~ 화면에서 관객에게 물어보는데 깜짝놀랐어요 ㅎㅋㅋ	영화음악
추억의 영화 마지막 엔딩장면에 나오는 음악 인상깊다	영화음악
파가니니의 일생을 제대로 전달하지도 못했고, 현대식으로 편곡된 저렴한 가렛식 파가니니곡들도 듣기 꺼림칙했다.강한 나르시즘에 빠진 연예인님 데이빗이 자기연출하려고 찍은 영화.음악을 빌미로 자기 광고하려고 찍은것같다. 빠르게 연주한다고 천재? 아니다.	영화음악
톱줄을 튕기는 듯한... 독창적인 모리꼬네의 음악은 압권이다.	영화음악
춤, 음악에 공감을 못하니 남는 것은 없다.	영화음악
음악 미술품...	영화음악
이건 그냥 음악으로 감성팔이 하는 싸구려 로맨스 영화..	영화음악
고증거친 화면과 배경음악, 탄탄한 시나리오로..	영화음악
No Diggity 부를때 오줌쌌다 그부분만 10번을 돌려봤다..음악 좋아하는사람은 무조건봐라!!!!	영화음악
음악도 좋고, 내용도 좋았습니다.	영화음악
다 알바야 뭐야?? 난 지루하고 음악도 생각보다별로라서 중간에 나왔는데	영화음악
음악과 인간과 그 시대상이 모두 적절히 어우러진 감동적인 영화였어요 :)	영화음악
오랜만에 본 음악영화라 좋았다:)	영화음악
감동적이고 음악짱좋음	영화음악
상상력이 기발한 독특한 호러무비. 크리스토퍼영의 음악도 좋고 87년도 영화인데 지금봐도 이만한 호러무비 없을 듯.	영화음악
HOT 한 천재음악가에 대한 제대로된 판타지를 갖게 하는!	영화음악
편한이야기,좋은음식,좋은음악 무엇이 더필요하리?	영화음악
음악은 최고 시작부터 끝까지 흥얼거렸다. 영화가 끝난 이후로도 흥얼거리게 된다. 그런데 두 남자 사이에서 일로나의 행동은 공감되지 않는다. 그냥 어장관리로밖에 안보여진다.	영화음악
중간중간에 나오는 bgm 맘에들음 ㅋ 성치형 차도에 차버리고 갈때가 간지	영화음악
어이없어 합채 정도 애들 넘치고넘치는 아이돌되고싶은애들아님? 썸띵이 왜 탈락이지? 완전어이없는 심사 ㅋㅋ 양현석 박진영이 합채밀어붙였겠지 심사의원 한명더 모셔와라 불공정심사다 시청자들기만하냐? 아무리 니들이 음악을 전문가라도 이건 진짜 아니다 ㅡㅡ	영화음악
흑인 특유의 신나는 음악이 너치는 영화..이제시대의 우리와 닮은..	영화음악
맨날 에스카플로네 등장할때 오케스트라음악나오면 감동먹었음	영화음악
몽환적음악	영화음악
배경,음악,, 헬레나의 여리한 얼굴이 좋다. 감성충만영화	영화음악
음악과 예술을 사랑하는, 그리고 '사랑'을 아는 사람들의 이야기...	영화음악
음악이랑 작화, 몰입감 최고!	영화음악
훌륭한 연기와 음악까지~~ 이건 정말 두번 봐도 될 영화다~~	영화음악
맷 데이먼의 절재된 연기가 완벽하다.실존 인물을 바탕으로 만들었기에 현실감을 더 해주기도 한다.영화의 러닝타임이 매우 길지만 그 만큼 빠져들게 한다.굿 셰퍼드 특유의 분위기와 음악은 너무나도 매력적.	영화음악
이것은 음악 다큐, 영화의 신경지	영화음악
빌보드에 나온 것도 아니고 왜 갔느냐고들 하더라.. 하지만 우린 음악이 아니라 인생을 느끼러 갔던거야.	영화음악
1점도 아까운 영화 원작을 크게 훼손시킨 쓰레기영화스토리도 완전 다르고 중국어때문에 집중이안되서 몰입또한 안되고 영화음악은 느려터지고원작생각하지 말고 볼려면 보고아니면 보지마세요 기분만더러워짐	영화음악
사실 관람 전에 별 다른 기대를 하지 않았었다. 관람 후에는 기대를 하지 않았던 점이 무척 다행이라고 생각했다. 추가: Rachmaninoff Piano Concerto No. 3 . 의 음악에서 Shine 이라는 영화를 떠오릴 것은 큰 수확	영화음악
아름다운 음악 한곡을 들은듯 풍부하게 남는 여운	영화음악
시간가는줄모르고봤다 지루하지도않고 음악도좋았다 연기너무잘해서 후반에 모차르트에게 고통과 슬픔이보여서 더 안타까웠다 몇번이고다시볼영화!!	영화음악
음악 영화라고 하기도 좀 그렇고 성장 영화라고 하기도 좀 그렇다. 어정쩡하고 어정쩡한 영화.	영화음악
ㅋㅋㅎㅎ음악이랑 완전웃긴다	영화음악
톤즈를 위해 의사가 되시고, 선생님이 되시고, 음악가가 되신 이태석 신부님. 존경합니다.	영화음악
처음엔 배우에 빠졌고 나중엔 영상과 음악에 빠져버렸다!좋아~♥	영화음악
어색한 연기의 극치 하지만 사운드 음악들은 굿	영화음악
가족끼리 볼 수 있는 케릭터가 너무 귀여운 재밌는 영화예요. 특히 음악 좋아하는 분들 강력히 추천해요. ^^	영화음악
ㄴㄴ 음악은 멋있는데 할머니들 너무 시름 그냥...	영화음악
스토리 굿 연기 굿 음악 굿 대형마트가지말고 동네 가게 이용해 주는거야 그게 너도 나도 잘사는 길	영화음악
일단 스토리가 고전동화의 원작에 충실합니다. 색감도 장면마다 미술작품처럼 정말 아름답구요. 어울어지는 음악도 훌륭하고 더빙도 영화에 몰입을 방해하지 않는 최선의 캐스팅이네요. 장인들이 공들여 고급스럽게 만들어낸 품격있는 명작입니다. 강추합니다~!!^^	영화음악
보는 내내 잔잔한 미소가 지어지는 영화. 거기다 음악도 좋고	영화음악
시즌3의 실패는 카리스마 음악의 진실의 깊이를 모두 갖은 김기련	영화음악
중학교때 낡은 비디오방에서 이 영화를 처음보구 장국영이란 남자를 미친듯이 사랑하게 되버리고 세상에 태어나 처음으로 내돈주고 음악테잎이란걸 사서들었다...아직도 그의 목소리가 귀에 아른거린다...	영화음악
1970년대에 사회적분위기땜에 명작된 영화 허나지금은 영화음악으로 더유명함	영화음악
내가 대학을 다녔던 90년대에 상영했던 영화를 그때는 영화음악이 참좋다고만 생각했는데 20년이 흐른뒤 네이버 영화보기로 보니 감동적이었다.	영화음악
영상과 음악이 어우러진 한편의 로망(Roman).	영화음악
음악영화!! 원스 어거스트러쉬 말할수없는비밀 그이상이다!!	영화음악
영화 시작부에 음악이 좋았던 기억이...	영화음악
최고의 영화입니다. 스토리, 배경, 음악, 메시지 모두 훌륭하네요	영화음악
실감하는 레고!!배경 음악도 재미있고...	영화음악
음악 영상 전개 다 좋다...잘 만든 공포영화!!	영화음악
주옥같은 콜 포터의 음악과 카메오 가수들을 보는 재미가 쏠쏠	영화음악
케냐의 그림같은 경치와 음악의 조화가 환상적인 영화입니다!	영화음악
bgm, 파리의 풍경 자체가 예술 !	영화음악
오래전에 봤지만...아바의 음악들이 너무 맘에 들었고...정말 어울렸다~	영화음악
음악도 별로고,아이들은 별로웃지않고,진짜재미없고,더빙은 괜찮았어요	영화음악
내가 음악과 영화를 좋아하는 이유를 느껴주게 한 영화	영화음악
mate의 음악은.. 정말.. 최고다. 영화로 만나니 더 새롭네	영화음악
다시 보고 싶습니다. 이렇게 오래된건지 몰랐네요. 주인공도 너무 멋지고, 음악도 좋고 ㅎㅎㅎ 갑자기 추억 돋네	영화음악
그냥 멜로 영화라고 하기엔 심도있는 영화. 음악도 좋고 수지라는 여자 참 매력있다. 미쉘파이퍼 노래실력! ost로 듣고 싶네	영화음악
음악만 예술	영화음악
어제내린비. 나의 어린 시절에 본 그 영화의 음악에 매료되었다	영화음악
관객과의 소통을 버린 영화. 연출, 흐름, 배경음악 모두 최악 스토리는 말할 것도 없고.. 과제인가요? 졸업작품인줄 알았습니다. 한국애니메이션을 사랑하는 사람으로써 굉장히 실망했습니다. 보는내내 관객을 너무 불편하게 했던 영화.	영화음악
배우들의 연기,호흡,몰입도,연출,음악 정말 환상의 오케스트라였다.	영화음악
호러무비 보다 4배속으루 돌려보긴 첨. 귀신들만큼 영화 진행속도 엄청 느리구 느려서 짱나는데 음악두 짜증남. 킬링타임으로두 부족한. 이건 b,c 급에두 못들어가는 영화. 영화 댓글 달아본적 엄는데 방금 보구 짜증나서 남긴. 절대 비추!	영화음악
우와 이런영화도있구나 연기력0.1 스토리0.2 음악ㅇ 합이 0.3 진짜 발연기는그렇다치고 중간중간나오는 60년대 통기타소리는 정말이지 최악이다	영화음악
정말 명작 히사이시조의 음악때문에 더 명작!!	영화음악
음악에 취했는지 영상에 취했는지 정말 마법에 걸린건지..	영화음악
배우들 연출 스토리 배경음악 모두 다 굉장한 수작이네요 한국에 이런 드라마가 나올수 있다니 정말 감동이예요	영화음악
잔잔한 음악영화 좋아하는 나에게도 밋밋한 영화.어바웃타임 > 비긴어게인 >> 블랙버드>> 송원	영화음악
중반에 좀 지루한 감은 있었지만, 환상적이었던 음악과 멋졌던 스토리 라인.	영화음악
음악 케릭터 분위기...대박영화...	영화음악
흑인의 현실에서 반영되는 음악이 뭔지 제대로 알고 싶다면.이게 바로 그럴 수 있는 영화.	영화음악
감동적!! 가끔씩 음악을 들었을 애 아들의 반응으로 피식 웃음이 나오는 영화였어요.	영화음악
나도 정말 동물좋아하는데 영화의 평은 별개다. 감독이 많은걸 시도한것같지만 결국 이도저도아닌ㄴ게 되버렷다. 전체적인 영화의 흐름도 그렇지만 개개의 이야기들도 별로엿다. 마지막장면에서 눈물흘린사람들이잇을것같은데 슬픈음악에 감동적글몇개 띄운다고해서 좋은영	영화음악
영화음악과 함께 진한 여운이..	영화음악
음악과 함께 전해져오는 메시지 !!	영화음악
음악 ㅈ나 쓰레기, 빰빰빠빠빱빠	영화음악
영화보는 내내 귀가 즐거운 기분이네요~한동안 잊고 살았던 음악에 대한 나의 욕망을 채우는 기분이라 정말 좋게 보고 나왔습니다!	영화음악
70년대 영화 보는 느낌...음악이랑 영상 기가 막히게 맞아 떨어지는데 겁나 웃김ㅋㅋ코미디 영화로 보시면 재밌게 보실수 있습니다	영화음악
음악이랑 빛나는 미모 외에는 볼 게 없음.... 아름다운 사랑이라는 건 누가 정의함? 내게는 아름답지 않았음	영화음악
음악 굿... 남배우 목소리 굿... b	영화음악
혼자 비디오로 보면서 감동했던 기억이.. 음악도 좋고..	영화음악
정말 감동적인 영화이구 음악의 효과를 받아서 더 멋진영화가 아니였나 싶습니다.	영화음악
음악은 정말 완벽했지만 선생들의 연기가 너무 너무 별로였다.ㅜ	영화음악
나도 학창시절 음악선생님이 떠오른다..	영화음악
내가 본 한국 드라마사상 최고의 수작. 작가의 필력, 감독의 연출력, 음악감독의 배경음악, 카메라워크, 배우들의 빼어난 연기력...모두 10점 만점에 10점. 최고.	영화음악
그 남자의 삶. 예술적영감 헨델의 음악까지...굿	영화음악
리브 타일러의 10대 후반, 샤를리즈 테론 20대 초반 때 리즈 시절 모습과 환상적인 영화음악. 한 마디로 대박 !!!	영화음악
처음에는 초롱 팬심으로 봤는데 갈수록 내용과 어울리는 배경음악들이 너무 달달하고 보고 있으면 행복해지네요. 완전 재밌습니다.	영화음악
1편이랑 너무 비교되서 왜봤는지 눈물이 다 났다. 마지막에가선 웃음만나왔음.어이없어서. 차라리 다른 영화나 볼껄..음악은 괜찮음.극연출도 괜찮았음. 내용은 아침막장드라마. 배우들도 실망스러움.	영화음악
음악영상 굿.	영화음악
유키 구라모토 음악을 듣는게 낫겠다.	영화음악
몽환적인 영상과 음악. 너무나 예쁜 이나영에 통통튀는 파란색까지!	영화음악
병운이가 희수 신발끈 묶어주면서 상처받았던 얘기하는 장면도 좋고, 둘이 돈받으러 돌아다니면서 등장하는 서울 곳곳을 보는 것도 좋고, 음악도 좋고 무엇보다 마지막 장면이 참 좋습니다	영화음악
나에겐 별로였음 . 음악이 몰입을 방해하고 스토리도 엉성하고	영화음악
좋았어요 영화이야기도 좋고 풍경도이국적이고 카고시티음악...계속 검색중 국내에는 별로 알려지지않았나...	영화음악
이것은 음악만 느낄께 아니라 스토리를 느껴야한다. 아름다운 우정... 이게 음악와 조화를 이룬것이다.	영화음악
영화만나오면모하나요 음악도갖이소개시켜주세요	영화음악
시사회보고 왔었는데요 강추합니다 화면도 음악도 좋았어요 또 보려고요 시네토크로 예매했답니다^*	영화음악
음악과 계속되는 전쟁씬 62년도를 생각하면 더욱 재미있다	영화음악
리들리 스콧의 영상미학과 한스 짐머의 음악... 후까란 바로 이런 것이다.	영화음악
지금껏 봐온 많은 영화 중에서 O.S.T가이렇게나 좋았던 영화는 처음입니다! 주인공들의 이야기 하나하나가 노래로 잘 표현된 영화입니다! 이런 영화를 140자로 표현해야 하는게 아쉬울 정도네요ㅠ 음악을 좋아하시는 분들께 정말 추천해드리고 싶습니다~!^^	영화음악
정신병자가 영화만들었나? 자길 버린 아버지에 대한 애증어린 복수 이게 넘과하게 그려진거같음. 캐릭터하며 영상하며 음악하며 하나부터 열까지 정말 감독스타일이 넘싫다.	영화음악
대회에 참가해서도 경쟁하기보다는 진심으로 음악을 즐기는 지휘자들의 모습이 감동적이었습니다.	영화음악
재미는 없지만 독특한 매력이 있는 영화가장 기억에 남는 건 남여주인공이 서로 만난 순간 나눈 스킨쉽 장면 이었다. 음악과 달듯 말듯한 그들의 몸짓과 손짓이 신비로웠다. 무섭고 슬픈영화였다..	영화음악
휴~~~앞스토리도 그렇구 똑같잖어.한놈은 싫다구 내빼구 한놈은 좋다구 들러붙구 ㅋ 음악들은 하나같이 왜그런지. 게이들 취향인가? 경례 휴~~~ 허접한 게이영화.	영화음악
평범식상한 스토리에 귀를 괴롭게 하는 촌스러운 음악	영화음악
007 중 음악은 이 영화가 최고, 전체적으로는 뷰 투 어 킬이 최고다	영화음악
타계하신 배우,윤인자 님께서 주연으로 열연을 보여주신 당시 우리 영화로는 보기드문 수작이라고 기억합니다.오래전, 극장에서 본 영화라서 기억은 가물 대지만 ,전편에 잔잔하게 흐르는 음악도 좋았었구요...윤인자 님의호연이 참,좋았다고 생각합니다.	영화음악
위트와 음악이 녹아든 영화. 똑똑한 천재가 아나라 주체적인 천재에 감화된다	영화음악
기대 안하고 봤는데 좋네요. 음악하는 사람에게는 강추	영화음악
중간중간 음악 선곡들이 제일 웃김. 웃기라고 한 선곡은 아니겠지만... 참재미없다...	영화음악
굳 음악도 좋고 영화가 주는 교훈도 있고 it's cool	영화음악
종교, 인종, 음악에 대한 색안경 없이 최대한 객관적으로 관람하려고 노력했습니다. 결론은 최악입니다. 다큐도 잘만들면 재미있다라는 생각에 봤는데 뭐 이런 망작이 다있나요. 평점 절대 믿지마세요. 감동과 힐링? 웃음만 나오네요	영화음악
천재음악가 베토벤의 일생에서 사랑이라는 일면을 부각해서 스토리를 입히고 재해석한 작품. 틈틈이 나오는 베토벤의 음악과 베토벤의 삶이 어우러져 보는 내내 가슴을 울립니다. 주연 배우의 흡입력 있는 연기가 일품입니다.	영화음악
일본이 만든 영화보다는 천군이 더낮다.거기다 천군 OST 음악도 좋다.	영화음악
한국영화중에 몇번을봐도 질리지않는건 이영화뿐오늘 다시보니 배우연기영상 다 좋지만 음악선곡이 최고음향감독님이 뉘신지 너무 매력적입니다	영화음악
역대최악의 리메이크를 싸지른 감독의 이름이 다름 아닌 팀 버튼. 스텝들이 불쌍해서 별 한 개라도 준다. 줄거리, 연출, 연기, 영상... 엉망이 아닌 건 대니 엘프먼의 음악과 에스텔라 워렌의 몸매 정도? 안타까움을 넘어 기가 찬다.	영화음악
썩 재밌진 않으나 제프 벡과 데이빗 커버데일이 음악에 참여해서	영화음악
담백하고 투박한 음악 영화	영화음악
모든 장면이 명장면, 배경음악도 감동적. 상큼한 대사가 너무 좋아.	영화음악
재밌네용~~ 야하기만하고 내용은별거없는허접한영화도많은데 내용도탄탄하고 몰입해서잘봤어요 다른부분도다훌륭하지만 연기력 음악 영상미 굿굿	영화음악
좋은 음악...아름다운 영화다	영화음악
이따위영화가 8점이상이라니...ㅋㅋㅋ...할말이없음..나도 참 다양한영화를 보는데 보다가 중단한 영화는 처음이다..아무리 재미없어도 10초씩 빨리감기로 다 봤는데..음악은 또 시도때도없이 계속나와서 몰입도 안되고....4-5점 정도가 적당	영화음악
이젠 이런게 영화로도 나오네 ㅋㅋㅋ 대한민국 음악계, 영화계 망했네 ㅋㅋ 다상업적인겄만 나오고	영화음악
음악이 정말 마음에들고 권격영화중 본영화중 거의 최고입니다~!!!	영화음악
음악이 가득한 영쿡영화라면 필수감상목록	영화음악
자극적으로 표현할수 있다면.. 오로지 음악으로써 나에게 오르가즘을 느낄수있다고 해줬달까~~~?	영화음악
최고의 오케스트라 공연을 상영하는 건 좋지만 2013년 베를린필 송년음악회를 신년음악회로 바꾸고, Live 중계라고 홍보하면서 4만원이나 받는 건 좀 아닌 거 같다...	영화음악
골드핑거라는 제목과,007 명성에 비해서는 2프로 부족한 느낌이네요..주제가음악,멋진 스위스풍경..그리고,한국인 악당 모자날리기가 골드핑거를 살렸다고 봐요 ㅋㅋ 보릿고개 시절..선진국 영화 보는 느낌이란?	영화음악
아직도 기억이생생한 백영규님의음악 다시한번 감상하고싶네여!	영화음악
명작 색감의 활용과 중국 특유 느낌의 음악 다 훌륭하다	영화음악
마지막 4중주도 아주 볼만한 클래식 음악 영화이기도 하겠지	영화음악
감독이 째즈가수가 아니였다면 이런 영화는 만들 수 없었을 것이다. 멋진 음악다큐!	영화음악
인디음악 분위기에 맞춰 억지로 짜낸 스토리는 현실괴리적이기만 하다. 상류층 십대의 환각과 환상 ? 젊은시절에 파업전야를 만든 사람이 현실감각을 잃고 이유 있는 투쟁에서 이유없는 반항과 개인주의로 스스로의 역사성을 단절시킨 졸작이다.	영화음악
좋아하는 배우들이 나오고, 배경음악은 좋아하는 노영심님이 한. 너무 좋은 드라마. ^^ 그런데. 이 드라마 보고. 헤어진 사람에 마음 헛갈리는 분은 없기를 T T 드라마랑 현실은 다르니까요	영화음악
음악을 못느끼셨다면 영화의 20%만 보신겁니다.	영화음악
시사회로 봤는데요. 1편보다 스토리는 너무 막장이고, 음악도 너무 강하게 지르고 휘몰아치네요. 화려한 볼거리를 제외하고는... 실망이 크네요	영화음악
음악을 들으면서 눈물을 흘릴 수 있다는 것을 가르쳐준 비틀즈의 영화 정말 감동임!	영화음악
정말 재밌게 봤다. 또 보고싶어지는 영화. 예전 좀 더 순수했던 시절이 생각나서 감정이입이 더 되고. 정말 마사미는 이 영화에서 최고인거 같다. 한국 여배우 다 갔다줘도 난 이 영화에 숏컷 마사미랑은 절때 안바꾼다. 음악도 정말 마음에 듬. 추억 새록	영화음악
음악 영화를 좋아하는데, 스토리가 정말 괜춘한듯 하네요.좋은 영화 만들어 주세요...	영화음악
음악이 쓸데없이 시끄럽고 내용은 유치하다. 배우들의 발연기, 뻔한 내용... 시간이 아까운 영화.	영화음악
음악만으로도 충분히 매력적... 따뜻함과 쓸쓸함이 동시에..	영화음악
칼같을것 같은 사람이 의외로 허당일때 느끼는 묘한 친근감이 가득 배어난다. 분위기,음악,연기력,대사 명품 4중주.	영화음악
007시리즈 중 최고라고 생각...5번도 넘게 봤지만 다른 시리즈에서 느낄수 없는 스펙타클함과 멋진음악 그리고 개인적으로 최고의 제임스 본드라고 생각하는 티모시 달튼...나만의 최고의 영화	영화음악
실화도 아니고, 음악도 모두 만들었다는!!!!!!Here we go, Rock & Roll!!	영화음악
뭐가 재미있다는건지 스토리가 안되면 음악이라도 집중할수있게 해주던가 괴로왔음	영화음악
반전내용이가슴아팠고음악도너무좋았고무엇보다기무라타쿠야의연기가최고였던드라마♡	영화음악
전형적인 틀이라도 독특한 아이디어나 영상이 있다면 지루해지진 않을텐데, 예상대로 진행하고 예상한만큼도 못 보여준다. 전문연기자가 아니니 연기 못하는건 이해하더라도 연출이, 대사가 너무하다. 특히 음악나올때의 뮤비스러운 플레시백.	영화음악
포스터랑 음악이 이쁨ㅋㅋㅋ	영화음악
1.전체적스토리와 주연 제외 나머지 인물들의 연기가 너무 오글오글(특히 여자주인공 첫사랑역 남자 대박;;;)2.BGM이 너무 구림.피아노 음악 빼고 다른것들 내가 다 창피결론 : 오로지 야한장면 보는게 목적이면 성공, 그 외의 것을 기대한다면 실패	영화음악
음악 감독이 조니 그린우드였네요 그리고 리치 먹는 장면은 일반적으로 가장이 가운데 앉는데 케빈이 가장의 위치에 앉아있는 것은 케빈이 사실상 그의 악마성으로 집안을 장악하고 있다는 걸 보여주려는 연출이 아니었나 개인적으로 생각해봅니다	영화음악
배경음악과 영상은 멋지던데 생각보다 내용은 실망스럽군...도도한 크리스티아노	영화음악
정말이지 뛰쳐나오고 싶던영화, 음악은 그런대로 좋았다.	영화음악
망작맞네. 드라고가 링에서 반칙쓰면서 싸운것도 아닌데 록키랑 똑같이 주먹날리면서 싸우는데 소련국민들이 왜 갑자기 록키의 투지에 반해서 록키를 응원하냐 말도안된다 막판 소련고위층이 기립박수치는거 압권이네. 왜 최악의감독상과 최악의 음악상인지 이해감	영화음악
음악하는 혹은 예술가의 순수한 열정이 느껴져서 좋다. 심지어 재미도 있다. 당신이 락을 좋아하던 말던간에!!	영화음악
배경음악, 연출, 배우들이 너무 완벽하네요.	영화음악
완벽했다..틸다 스윈튼은 신비롭고 아름답고 톰 히들스턴은 조니뎁이 떠올랐다..음악좋고 메시지도 좋고~	영화음악
우선 배우들의 내면연기가 훌륭하고 감독의 세련된 연출과 음악때문에 보는 내내 눈과 귀가 즐겁다. 감각적인 영화. 예술가들이 좋아할 것 같음	영화음악
양동근의 내면연기가 돋보인다 거기다 외국어로 연기를 해야하고 몸도 잘 써야되니 그의 노력이 고스란히 보여 좋았다. 10점짜리 영화는 아니지만 10점을 줘도 아깝지 않은 영화. 배우들도 좋고 음악도 좋았다.	영화음악
70~80년대 락음악과 그시대상을 잘 버무려 만든 유쾌한 영화. 그런데 어딘가 지금 상황과도 다르지 않아 보이는...	영화음악
가정과 혁명, 사랑과 우정 -- 자칫 진부할 수도 있었던 소녀의 성장기를 엘르 패닝의 풍부한 연기와 시대적 낭만 속에 유기적으로 풀어낸 1시간 30분의 그림. 담담한 진행, 낙엽향 나는 음악, 그리고 충격적인 스토리의 삼박자에 넋을 잃었다.	영화음악
극 노잼 완전 음악성은 찾아볼수 없을 뿐더러 재미 감동도 없는 영화	영화음악
배우들은 좋았지만 역시나 ... 음악부터 스토리까지 정말 재미없네요 시간을 버렸습니다.	영화음악
스토리하고 음악이 잘맞아서 재미있었다...	영화음악
OOO기 영화 음악도 촌시럽고 전에 보던 플롯에 막장드라마	영화음악
시도 때도 없이 튀어나오는 음악들 때문에 몰입 곤란	영화음악
음악과 각본, 배우 열연까지 삼박자를 갖춘 영화. 강추!!!	영화음악
감독의 넘치는 기지와 센스, 미려한 영상과 아름다운 음악	영화음악
재미있는 시나리오와 음악의 환상적인 조합!	영화음악
둘의연기호흡이 장난아닐정도로 완벽했고 제일 가슴을 찡하게했던 장면은 한석규가 이제훈을 위해 심사위원한테 기회달라고 난리쳤을때가 제일소름돋더라...꼭진짜스승과 제자를 보는듯한 연기였다.나도 음악하는사람으로써 저런스승을 만나서 꿈을 이루고싶다.	영화음악
셰익스피어의 명작중 하나. 영상, 음악, 재연 등 모든게 거의 완벽했다. 특히 젊은이들은 헨리 5세와 자신을 돌아보며 감상하는 것을 추천한다.	영화음악
뭐이리늘려빼는지좋은배우들모아서졸작만든감독과 작가는각성하심이...툭하면슬로우화면 어울리지않은 효과음악정적 어두운화면 좋은것도한두번이지짜증나네요배우들이아깝네요 ㅜㅜ	영화음악
음악만 긴장있음.	영화음악
영화가 끝난후 텅비어버린 가슴..진실이 왜곡되는 정치적 이념의 송가..	역사/현실고증
사실 왜곡 한 스푼, 한쪽 시각 한 스푼	역사/현실고증
역사왜곡은 뭐 각색의 영역이라 그렇다치고 영화자체로도 참 B급 스런 쌈마이영화.그냥 머리를 비우고 멍하니 시간을 때우고 싶은게 아니라면 추천하진 않습니다	역사/현실고증
쓰레기. 살아있는 고증오류의 신화	역사/현실고증
마지막 너무 먹먹하고 슬프네요 부모님 울때 ㅜㅜ 영상미가 신선하고 괜찮았지만 미야자키님이 은퇴작으로 이걸 했더라면;;; 왜 왜곡 영화 만들어서...; 막판에 욕을 먹는지;;; 쩝	역사/현실고증
독실한 신자인 제 친구도 보고 별로라구 하네요. 종교적으로 왜곡된게 많다고... 전 종교 안믿어서 모르겠지만 영화 자체도 그리 긴장감 없고 좀 지루했습니다.	역사/현실고증
그냥 영화판 자서전이네.. 여러 고증을 하려는 점은 훌륭하나 일반인이 이 영화를 볼 이유가 전혀 없고 결정적으로 추상 표현주의 작품에 대해 경멸을 갖게 됐다	역사/현실고증
고증거친 화면과 배경음악, 탄탄한 시나리오로..	역사/현실고증
묻지도 따지지도 않고, 일본 /2차세계대전/ 감동적인이야기 세가지 키워드만 봐도 각 나온다. 당시 상황에 비록침략국이었을지라도 어린아이들은 피해자였을수있다고좋게 생각하려해도 사과없이 오히려 역사를 왜곡하려는 그네들이 만든 영화라니 심히 의도가 의심된다	역사/현실고증
오늘 다큐멘터리랑 비교해 보면서 진짜 실제 상황이랑 똑같아서 엄청 놀랬다.. 너무 사실적인 고증이 재미를 반감시키지만.. 북베트남군의 용기는 정말 대단했다.. 10중 8,9 죽을 줄 알면서도.. 우리는 저럴 수 있을까?	역사/현실고증
역사부정과 역사왜곡 국가의 만남. 내용도 그다지...	역사/현실고증
어느순간 그냥 '뭐지? 헐 역사적 배경은 당연히 알고 있지만 이건아니다	역사/현실고증
정말 끔찍하게 암걸리는 영화였다제목을 병림픽이라고 하지그나마 대통령이랑 유해진역할이 암 안걸렸음그리고 주인공남자는 왜 안걸리냐 버프받았냐캐릭터 거의 전부가 다 극혐이였음 근데 그게고증이 잘되보이긴함 우리나라 영화라서	역사/현실고증
이거이거, 왜곡이 너무 심하다?	역사/현실고증
논란 여부를 떠나 영화 자체가 재미없음. 차라리 영화에서도 언급되었던 안창남이 영화로 제작되었다면 더 좋았을 것을. 객관적 사실에 바탕으로 한 것에 가미된 픽션이 너무나도 어처구니가 없음. 그로 인해 왜곡된 역사를 사실로 인식하는 사람들도 있음	역사/현실고증
역사왜곡 정말 할말이없음	역사/현실고증
공중파 방송국은 반성좀 하자. 이런게 드라마지. 막장, 역사왜곡 따위 그만하고...	역사/현실고증
개연성없는 전개, 상황에 맞지않는 대사, 거기다 왜곡된 역사인식까지. 정말 엉망진창	역사/현실고증
곰TV들어갓다 자동으로 재생되길레 봤는대 역사왜곡이 심각함.우리나라나 남에껄 자기들꺼라 홍보하네....황당무게하다 못해 역겨움....초반 15분만 약간 코믹하게 웃겼고 나머진 역사날조의 일본우익놈들 좋아라 하게 만든 병맛 영화.	역사/현실고증
뭐 역사를 다룬영화니 역사왜곡이느니 어쩌구하는 인간들많다 근데 영화는 영화일뿐이고전쟁중에서의 시점은 스파르타시점이니 그 시점에서의 페르시아가 그렇게보인다는 식으로 꾸민건데(적군이고 스파르타 입장이니) 그냥 영화로봐라 영화로 무슨 역사공부하냐?	역사/현실고증
역사적 사실을 정확하게 전달했다고는 말하지못하겠으나예술에 대한 정신이나 마음가짐을 중점으로두고 이루지못한, 이루지못할 사랑을 마지막까지 예술로 표현했다는점을 높게평가한다. 작품속 베드신을 욕하지마라. 영화에서말했듯 예술을 쓰레기같은눈으로 보고평가마라.	역사/현실고증
인간 조조만 있다. 고증은 없고 스토리도 없으며 구성과 연출 영상까지도 저질이다.	역사/현실고증
이걸 보고 고증을 기대한다면 전 김치 전사를 보고 이국심을 가지겠습니다.	역사/현실고증
아더왕 전설의 배경만 현실성 있을 뿐 그 외의 연출, 소품등 다 졸작중의 졸작. 로마군이 영국에서 철수한 5세기 경에 중세식 갑옷? 켈트계 선주민이 투석기? 웃기지도 않는다 역사고증이 인물,시대상만 반영하면 충분할 것이라 헛짚은 망작	역사/현실고증
어둡고 폐쇄된 동굴에서의 괴물과 사투를 잘 다룬 B급 영화 디센트의 감독에게 로마시대의 철저한 고증 및 규모의 스펙터클을 기대한 것이 아예 잘못이었던 듯... 그렇다고 쫓고 쫓기는 추격전의 스릴이라도 있던가... 어설픈 스토리와 수준 떨어지는 연출	역사/현실고증
사실을 왜곡하고 선동하는 영화 '다이빙벨' 이 영화를 본 아이들, 혹은 대한민국 후손들이 왜곡된 영화를 보고 선동달할까봐 겁이난다. 여기 봐라 수많은 사람들이 이미 다이빙벨은 사기극으로 완전히 밝혀졌는데도 이렇듯 헛소리를 하는 것을 보면... ㅉㅉ	역사/현실고증
줄리아 로버츠 때문에 억지로 봤다. 스토리는 중심을 제대로 못잡고 왔다갔다 산만하다. 집중이 안된다. 반면 복식,고증은 완벽하다. 제작진들에게 박수를 보낸다. 배우들의 연기도 뛰어나고.. 감독의 산만한 스토리,연출이 모든걸 망친 영화.	역사/현실고증
고증을 씹어드심. 이런 장르에는 손을 안대시는 게 나을 듯 하다;;;	역사/현실고증
어렸을 땐 멋모르고 봤던 영화. 크고 보니 거짓선동영화. 미디어가 갖는 파급력은 그만큼 어마어마하다. 나야 깨달았지만, 이 영화를 비롯하여 변호인같은 왜곡영화들을 본 어린세대들은 그것을 숨겨진 진실인양 받아들일 것 아닌가?	역사/현실고증
꼼꼼한 고증! 장대한 셋트, 로케, 인력에.. 훌륭한 배우들로 만든 손빈 스토리인데, 절박함도 감동도 없다. 6각관계를 구겨넣고서 100분으로 줄이니, 부부클리닉이 됐지. 특등급 소고기로 냉동햄버거를 만드는 제작진이 전세계에 깔렸구나! 월드워Z~로다!	역사/현실고증
진실을 왜곡하는 진짜진짜 쓰레기영화	역사/현실고증
역사적 고증도 그렇고 리메이크도 망했고, 쓰레기	역사/현실고증
2014 EBS 국어 문제집 지문에 본 드라마 대본중 일부가 실렸습니다. 그것을 계기로 수능이 끝나고 한창 보고 있는데요. 최고의 드라마이고 한치의 긴장감도 놓을 수 없는 훌륭한 작품이라 사료됩니다. 한글의 우수성과 세종대왕의 업적과 성품에 감탄합니다	역사/현실고증
왜곡된 삶의 형성, 과정, 그리고 치유를 보여주는 수준 높은 영화	역사/현실고증
밀리터리 고증따위는 무시한다.	역사/현실고증
문제있는 행동을 영화기술로 훌륭하게 왜곡한 영화. 사실왜곡은 또 하나의 배교인데... 잘못된 사실 전파로 많은 사람들이 영향을 받게된다면 하나님은 분노할 것이다.	역사/현실고증
1화 보았는데 품계석이 문종대에 있다니.. 관모랑 관복모두 조선후기때의 것이네요 역사고증이 엉망입니다 더욱이 함은정 임요한처 연기 정말 못봐주겠음..	역사/현실고증
역사왜곡 쩐다. 정말로, 다시는 나오지 말아야할 드라마	역사/현실고증
7~8점정도는 되는데 현실왜곡해서 1점줌. 마지막에 말이되냐. 주인공 버프 개사기. 풉... 현실이였으면 되려 개박살. 저런식으로 영화에서라도 일진 이겨보고싶은갚네? 피해의식쩐다. 현실에선 복수하러가서 불구되겠지. 셔틀들을 위한 현실도피영화.	역사/현실고증
비뚤어진 시각교묘한 역사왜곡	역사/현실고증
역사 왜곡 영화.. 그 당시에 이런 무기가 있었다면 지금 우리나라는 분단국가가 아닌 대륙을 통일하고 호령하고 있었을지도 모른다. 영화 자체는 재밌으나 과장된게 심해서 평점 조절용으로 1점준다.	역사/현실고증
자본력은 있어도 고증과 진지함은 없는 작품.	역사/현실고증
정말 일본입장에서 불편한 진실을 영화로 만들기 쉽지 않았을 텐데 역사적 사실들이 담겨있어 좋았습니다. 이 영화에서 지향하는 것은 크게 보면 인류애지만, 일본인들의 시선으로 바라본 재일동포의 삶과 근대 우리나라에 대한 생각을 엿볼 수 있어 좋았습니다.	역사/현실고증
자국민의 역사를 자국민이 왜곡하는 이상한 나라	역사/현실고증
현실을 리얼하게 담았지만.. 또 다른 현실을 왜곡하는 부분도 많음.	역사/현실고증
한국 밀리터리 영화는 믿을 물건이 못된다. 고증도 엉망이고 감독은 지 꼴리는대로 만드는게 우리나라 영화 감독들인데 이런 평범한 군사영화에 뭘 바라는가?	역사/현실고증
역사적 고증을 통한 표현은 좋았으나 영화 자체의 흥미는 최악이다.	역사/현실고증
개연성도 없고 역사적 고증도 없고 지루한 피튀김만 있는 쓰레기 영화	역사/현실고증
심각하게 역사 왜곡...	역사/현실고증
우리 나라 드라마 계가 망해간다는것을 몸소 보여준다. 연기력 쓰레기에 그리 좋은 스토리도 아닌데 이렇게 호응해주는 사람들이 신기할 지경. 왕의 연애 소설이나 다룬 작품. 역사적 사실이 담겨있지도 않은 사극을 봐봤자 몰입도도 떨어지고 말도 안되는 설정.	역사/현실고증
정말 미친듯 웃을 수 있어요~ 몰랐던 역사적 사실도 알게되고~출연자분 스텝분들 고생 많으시겠어요제 8의 멤버 이윤상님 나오실 때마다 웃겨요연기력에 감탄도 하게되고그리고 역시 정말 장동민 최고!!!시즌2 2번째 촬영에 콩이 또 나와서 즐겁습니다	역사/현실고증
미친;; 이거 진짜 평점 왜이래;; 내가 본 최고의 전쟁 영화인데;; 고증을 이래 잘한 영화도 잘 없다;; 어린것들이 도대체 평점을 어찌 매겼길래;; ㄷㄷㄷ	역사/현실고증
역사왜곡 뿐만 아니라 재미가 없어.. 무협영화 좋은 사람만 보셈	역사/현실고증
다시봐도 오글거리고 쓰레기라고 생각한다. 고증이 망한것도 그렇고 스토리도 뜬금없고 개연성 없게 전개되고 액션만 볼거면 차라리 게임하는게 낳지않나 생각한다. 새로운것도 없고 뻔한 클리셰일뿐이다. 유치하면서도 오글거리지만 않아도 좋았을텐데	역사/현실고증
댓글보니까 역사왜곡쩐다고 하는데 이건 이미 아나스타샤라고 거짓주장했던 한 여자의 환상을 바탕으로 했다는데 실제아나스타샤이야기로하면 잔인함...이미 허구를 바탕으로 어린애들이 볼 수있도록 구성한것뿐이었는데 삐뚤게바라보다니..이거말잘만들엇음!	역사/현실고증
미국의 1차 킬링필드의 역사왜곡	역사/현실고증
역사를 왜곡한 영화라고 밖에 볼 수 없을듯...	역사/현실고증
닥추말이필요없다내생의최고의영화다 어쩌면 미래얘기를통해 2차전쟁의 왜곡을 끄집어내는것같다 개강추	역사/현실고증
내가 봤던 사극드라마 중 제일 재밌었는데 왜곡 심한거 빼곤뭐..	역사/현실고증
올만에 쓰레기를 본 소감이군..유아틱 어거지 감동 연출에 대본소 닭살무협역사만화 + 뭔 역사고증을 개판 어거지 시나리오 + 스티붕 유 까지 쓰레기요소는 다 쓸어담아놨다	역사/현실고증
아...대풍수 답안나온다. 사극은 내용보다 역사적고증이더중요하거늘 저게어딜봐서 고련지.. Mbc무신보고쫌배워야될듯 sbs는사극만들지마세요. 대풍수망해라!!	역사/현실고증
머하냐 왜곡 지린다	역사/현실고증
주몽보다 더한 엄청난 역사왜곡 시나리오 작가 어떤 새끼야 한국사 읽어 보기나 했냐?	역사/현실고증
고증 똥망,개연성 부족,사이고 다카모리 미화 3박자가 어울려진 미화 영화.무슨 세이난 전쟁 때 사이고 다카모리 군대가 칼만 들고 싸움ㅋㅋㅋ 대포,총 다있었는데 정부군보다 후달린 것 뿐 그리고 정부군은 보병만 데리고 왔나 카빈기병 어디갔냐? 버리고 왔니	역사/현실고증
중국인 특유의 과장, 허풍... 있어보이려고 안간힘 쓴 노력은 가상하나, 고증과 현실감 떨어지는 설정이 거북스럽다... 도대체 그들은 왜 이렇게까지 스스로를 과대포장하는 것인지...	역사/현실고증
영화도 재미없고 고증도 똥망, 우리나라에 물소가 어딨냐	역사/현실고증
역사의 왜곡과 스토리가 약간 실망스러웟지만 액션과 연출이 워낙 뛰어나 별9개	역사/현실고증
고증은 엉망이며 리얼리티또한 떨어지고 감독은 GP506과 알포인트의 퀼리티를 노렸으나 그건 감독만의 개인적 착각이였다. 다시 연구하고 다시 만들어라. 애초에 여군이 등장 하는 것 부터가 비현실적.	역사/현실고증
크랭크 카메라로 찍은 것 같은 씬만 스무번 넘게 나오는데 보다가 울렁거려서 토할뻔. 영화에 나오는 게이들도 너무 왜곡되고 과장되어 있어서 오히려 감독(혹은 시나리오 작가)이 호모포비아 같다. 마지막 반전은 그냥 반전을 위한 반전 할 말 없음	역사/현실고증
SBS의 역작... 고증에 무지 힘쓴 드라마..!	역사/현실고증
세뇌는 없는 사실을 왜곡해서 강압적으로 사상주입을 시키는게 세뇌고 북한 실태를 다룬게 세뇌면 실제 북한이 저러지 않고 평화로운 민주주의 국가라는거냐 저 아래 han0 OO. 지금까지도 강제노역에 인권탄압에 숙청을 강행하는곳이 북한인데 세뇌는 염병ㅉㅉ	역사/현실고증
재미 하나도 없다 골때리는 역사왜곡 인종비하 적 내용은 예상하고 봤다 거기까지는 괜찮다 그런데 내용이 영... 전편 300이 재미있었던건 오락적 액션과 내용이 맘에 들었는데 이번편 주인공은 지가 무슨 이순신 장군 마냥 고뇌를 하고 있다...	역사/현실고증
영국 귀족사회의 완벽한 고증, 세련된 서사구조, 미결의 여운, 모든것이 완벽하다	역사/현실고증
이렇게 재미없는 애니는 처음 ..역사왜곡 한 애니라는데 나는 너무 재미없어서 십분보고 껏다 지루하고 잠오네	역사/현실고증
재미를 위한다면 10점. 연기력도 다들 괜찮음. 다만 스토리로 따지자면 왜곡된 부분이 있음. 그래도 영화를 보는내내 즐거웠다.	역사/현실고증
역사왜곡에.. 스토리도 빈약함. 작가의 전작이 대왕세종, 불멸의 이순신이었네?뭐지?게다가 김유정 발연기 너무 심함. 아역치곤 잘하는거였지. 아직 극을 이끌어갈 능력은 많이 부족함. 그나마 3점은 박은빈의 명연기 때문에 주는거임.	역사/현실고증
스토리/고증적으로 막장인건 감점요인.	역사/현실고증
해학과 전쟁상황을 제대로 고증한 수작	역사/현실고증
잘 만든 영화가 사람의 생각을 바꿀수있습니다.자신들을 피해받은 나라로 묘사하며 역사왜곡을 하는 이영화는 무섭다.순수한 아이들만 희생되었다.일본은 왜 자기자신들이 한짓을 인정하고 사과하려하지않을까	역사/현실고증
고증이 엉망이면 상상력이라도 제대로 발휘하던가.	역사/현실고증
70년대초반 서울모습을 볼수있는 사료영화.	역사/현실고증
6.25 후 4년이 지난 시대. 사료의 가치가 있다.	역사/현실고증
역사적 사실 고증은 안드로메다로 보내고 뻥칠꺼면 재미라도 있게 만들던가..	역사/현실고증
역사왜곡은 안좋지만. 드라마화로는 잘 봤습니다.	역사/현실고증
역사적 사실과 너무 달라 아이들에게 잘못된 역사지식을 심어줄 우려가 있음	역사/현실고증
좀비영화 주제에 에지간한 한국 전쟁영화보다 고증이 더 좋아서 10점 준다	역사/현실고증
에휴 좀 고증 안챙김? 한반도의 공룡은 옛날 꺼니깐 이해하고이건 뭥미	역사/현실고증
스토리를 지나치게 미화하고 왜곡하다. 기왕에 건드릴꺼면 해피엔딩으로 끝나게나 하지 주인공 불쌍해서 우짜노.	역사/현실고증
본격 다큐멘터리 영화가 애니가 되는 영화.... 우리나라는 재미만 있으면 고증은 상관없다는 것을 알게 해 주는 영화....다큐라 읽고 애니라 말한다	역사/현실고증
엄청난 왜곡 심해...	역사/현실고증
원균을 미화시킨 이유는 아마도 부끄러워서 그랬을꺼에요 고증도 중요하지만 100퍼센트 똑같다면 다큐멘터리랑 다를게없지요	역사/현실고증
성삼위이신 예수의 측면이 아닌 연약한 인간화를 부각시켜 왜곡의 소지만 남겨두었다.	역사/현실고증
역사적 배경을 떠나 자신의 뿌리를 잊고 자문화의 소중함을 잊은 채 서구문화에 대한 맹목적인 동경은 종속적인 문화로 변질된다. 그 결과 스스로 빚어낸 오리엔탈리즘. 한편 영화 아바타의 느낌과 상당히 유사함.	역사/현실고증
하나님에 대한 성품을 완전히 왜곡한것 같아요.	역사/현실고증
역사적 사실과 너무 달라서 재미 없었다..동귀비 죽인건 한참 전 일이고 극중 시대는 조조가 60살이 넘었을 때인데.. 너무 젊게 나옴	역사/현실고증
너무 허구적이고 사실을 왜곡한영화.야인시대보다 못해	역사/현실고증
다들 역사왜곡이다 말이 많지만, 좋은 사극인가를 떠나서 좋은 작품인것은 분명합니다. 작가가 글을 쓰는데 있어서 역사의 어느 한줄에서 영감을 얻어 본인이 하고 싶은 이야기를 하려는건 자유에요.배우들 연기도 저정도면 정말 최상...	역사/현실고증
스테로이드에 관한 왜곡적인 시각과 많은정보들을 간단하게 풀어내서 정말 좋았고 한편의 영화를보듯 정말 재밌게봤던 다큐	역사/현실고증
단돈 몇천원으로 이런 작품을 볼 수 있다는 것이 감사할 정도.. 고증 재현 연기 연출 무엇하나 빠지는 것이 없으며 지금 현시대를 살아가는 우리에게 던지는 메세지또한 매우 묵직하게 다가온다	역사/현실고증
일루미나티식 역사왜곡 사극ㅋㅋ드라마 중에 진영 내의 연개소문 뒤에 붙어있는 시는 모택동이 중국의 영웅들을 찬양한 시여서 가십거리가 되었고, 연개소문의 눈에 진하게 그렸던 검은스모키화장과 삼족오 암시는 일루미나티가 가장 이용하기 좋은 함정이었죠.	역사/현실고증
영화의힘! 엔딩신의왜곡된역사설명과대비되어나오는희생자들의이름..훌륭한연출!	역사/현실고증
6..25 거제도 포로수용소에 왠 ak자동소총 고증부터 다시해라. 손발이 오그라드네	역사/현실고증
건국 이후 대한민국에서 만든 드라마 중에서는 제일 잘 만든 드라마라고 생각한다. 스토리와 시대고증이 최고였고 다양한 연기가자 적재적소에 배치되어 연기의 리얼리티를 잘 살려주었다. 특히 복태엄마!...	역사/현실고증
이거 왜곡이 있어도 요즘사극들보다는 낫습니다.	역사/현실고증
한복만 입힌 현대멜로극 고증은 바라지도않지만 옥의티나 주연들 발연기...	역사/현실고증
특징 잘묘사했다느니 하는애들 뭐냐. 고증이 완전 개판인데	역사/현실고증
진실은 거짓과 왜곡과 축소를 이길 수 있습니다.	역사/현실고증
아무리 영화라도 어느정도 고증을 해서 현실적인 요소가 반영되야 하는데, 만화같은 엉터리 장면들 투성이라 실소가 절로 나온다. 오타쿠들이나 손뼉치며 좋아할 법한 영화	역사/현실고증
민주화의 탈을 쓴 왜곡된 역사을 진실인냥 받아들이지 말기를....	역사/현실고증
지나친 왜곡은 곤란.. 김치양... 강조..천추태후..	역사/현실고증
B급 컨셉이면 B급답게 그냥 웃기려고나 할것이지(그나마도 안웃기지만) 역사왜곡에 훈장질까지 아주 대단한 영화. 손예진은 사람은 그렇게 잘죽이면서 고래는 왜 못잡나? 물레방아로 죽인 사람이 이성계보다 많을듯	역사/현실고증
아... 이 동사서독이 예전 그 동사서독이였나?! 이제 더 이상 창작자의 표현의도를 왜곡하는 가위질은 이땅에서 사라지길..	역사/현실고증
명량이라 비교도 말아라. 두 작품다 역사왜곡이 있었지만 명량은 영화이기에 가능한 전투씬을 했을 뿐 내용은 드라마 한편보다 못 한다	역사/현실고증
전투씬은 용의눈물만 못하고 특수효과 안습 우리스스로 역사왜곡	역사/현실고증
퇴폐적으로 면모한 로마를 이보다 더 자극적으로 고증할 순 없다.	역사/현실고증
왜곡된 순수함이 가지고 올 수 있는 비극.	역사/현실고증
설경구. 박해일 연기력 소름돋는다. 역사적 배경.사회적 배경을 잘 아는 세대에게 훨씬 다가갈 영화.	역사/현실고증
고증을 초월한 최고의 사극 명작. 지금까지의 모든 사극 작품들 중 작품성에서 이를 따라잡은 것은 아직까지 못봤다.	역사/현실고증
이 영화에서말하는건 전쟁은 누구를위한것인가를 표현한것같은데 일본이피해자라고 잘못이해한사람이 있네;;민간인이 주인공인데 뭔 역사왜곡,우익이야	역사/현실고증
잘 다루지 않던 병자호란에 대해서도 관심을 가지게되었고 각본, 배우, 미술 등 나무랄 것이 없는 드라마입니다. 일각의 역사왜곡과 자극성에 대한 비판은 드라마의큰틀에서 볼 때 문제가 되지 않을 만큼 훌륭한 드라마입니다!	역사/현실고증
1941년이면 2차 겨울전쟁 시기인데, 당시 참전국이 아니었던 미국이 나치 독일과 동맹인 핀란드를 돕기 위해 군대를 파견했다는 배경스토리 자체가 너무 허술하다. 뭐 애초에 고증을 따질한만 장르는 아니지만... 그건 둘째치더라도 애초에 재미가 없다.	역사/현실고증
역사왜곡/고증문제는 논외로 치고, 최고의 정치사극이 아닐까 싶음. 정치에서 선악이란 없다, 정치판에서 영원한 적은 없다란 말을 가장 완벽하게 표현해낸 드라마인듯. 모든 사건의 중심이 각각의 정치세력이 추구하는 가치관의 대립이란것에 촛점을 맞춘 걸작~	역사/현실고증
냉정하고 객관적으로 이 드라마 소재는 이미 영화로 나온거 재탕일뿐, 신선하지도않고 참신하지도 않다. 더더군다나 역사적 사실에 기초한것도아니고 인물만 갖다쓴 픽션 일뿐, 배우들에 연기도 새로울것도 없고 후까시만 잔득 준 느낌!!! 맹목적으로 좋다하지마라	역사/현실고증
고증 짱짱맨 이걸 2012년에 나온 영화고증이라는 신기.. 엑스트라 공룡들 디자인은 임파서블 픽쳐스에 워킹위드 다이노소어랑 너무 비슷함	역사/현실고증
이거야말로 명예훼손에 역사를 왜곡하는 진정한 쓰레기 일본이랑 다를바없다0점도 아까움	역사/현실고증
왜곡에 흥한 일본극우는 왜곡으로 망하라! 진실은 승리한다!	역사/현실고증
역사왜곡 쩌는구나. 제정러시아 왕족들을 마치 선량하고 좋은 인간들인양 묘사하고 러시아혁명은 폭동으로 묘사하는 이런 악의적이고 나쁜 애니는 1점도 못준다!	역사/현실고증
현실 왜곡이 교과서급; 달라도 너무 다르잖아!	역사/현실고증
천안함 용사들을 욕되게하지마라. 종북세력들을 척결해야한다. 니들이 진실을 왜곡하는거다 부끄러운줄 알아라 .	역사/현실고증
어느 이야기건 사실을 미화시켜서 왜곡되게 만드는일은 없어야한다고 생각합니다. 영화의 또다른 주인공인 주민들에 대한 예의가 아니죠.	역사/현실고증
"""여러분 이거 """"다큐""""라는 타이틀을 달고 나온거 아시죠? 쥬라기 공원 시리즈는 엄연히 픽션이고 설정상 고증오류가 나와도 딱히 문제될건 없는데, 이건 다큐라고요 !!심지어 TV판보다 더 고증이 안좋아지면 이건 뭐 어쩌라는거죠..."""	역사/현실고증
역사 왜곡도 진짜 심각한 문제지만 그걸 차지해두고서라도 지루하기까지... 가지가지 한다;; 배우들 연기력 말곤 볼거 없음..	역사/현실고증
고려말 조선초 역사에 관심이 많아서 끝까지 참고 봤지만 작가의 상상력이 도가 지나쳐서 역사왜곡으로 보여졌다. 의상소품이 너무 화려하여 패션쇼를 보는 느낌..역사극이 이러면 안되는데.. 가벼운 트렌디 시트콤 만들던 사람이 갑자기 사극을 만든 느낌	역사/현실고증
그저그런 왜곡된 생각을 가질수 있겠다.	역사/현실고증
엘런 파커는 대단한 감독이지만 내용은 주관적인 왜곡의 대향연.	역사/현실고증
"""미군 철모 카버가 베트남전 用 """"미첼 패턴"""" 이 아닌 베트남전 이후에 사용된 우드랜드 패턴이라 고증에서 옥의 티를 내서 아쉬운 영화임"""	역사/현실고증
고증 ? 사료 ?모두다 말안되고 스타일도 작고 인물간 사건 대립만 일어나서 참 ㅡㅡ	역사/현실고증
질문은 그럴싸했으나, 전문가들의 증언과 고증을 뺀 그들의 여행기는 진부하고 결론과 논리는 이제까지 우리가 알던 이순신에서 크게 벗어나지 않았습니다. 대체 무엇을 말하고 싶었던 것인지... 그래서 이 영화 혹시 2번째 것도 나오는 건 아니겠지요?	역사/현실고증
역사좀 왜곡하지마요, 이건 정말 너무심하네	역사/현실고증
역사 왜곡... 근데 그게 작품성에 전혀 도움이 안된단 말이지.	역사/현실고증
시간순서를 뒤바꾸고, 환상을 집어넣고, 기억을 왜곡시켜봐도 결국은 뻔한 치정살인	역사/현실고증
소설을 이렇게 왜곡시키다니. 빨치산의 순수성과 민족반역자문제는 다루지도 않았구나	역사/현실고증
코미디 장르라고 상황고증 없이 웃길려고 하니까 대미는 커녕 몰입도 제로에 분노가 치미는 영화.시나리오 이전에 시대에 맞는 의상 화장 말투 이런 기본적인 것부터 좀 지켜라. 관객 수준이 얼마나 높아 졌는데 영구와땡칠이만도 못한 억지 웃음 설정	역사/현실고증
고증, 액션, 스토리, 연출...뭐 하나 제대로 된게 없는 영화	역사/현실고증
영화니까 각색들어가고 고증 어긋나는건 이해하겠는데, 김희선 앞세운 마케팅에 낚이지 마. 걍 단역이야.	역사/현실고증
만사형통! 서로 왜곡하며 기억하는 인생사.	역사/현실고증
진정한 친일. 우익단체가 아닌 잘 못된 역사를 합리화 하지않고 인정하며 피해가족과같이아파했고 지금도 왜곡을 바로잡으려 애쓰는 소수의 그들이 진정한 친일이라 생각이든다. 진심으로 일본을 사랑하기 때문에 할 수 있는 용기와 행동에 마음으로 응원한다.	역사/현실고증
국가 영웅을 위해 모두 한 몸 다 바쳐야 한다는 불편한 국가주의를 마치 종교적 순교처럼 그렸네. 쑨원이 봤다면 놀라서 펄쩍 뛰었을 심각한 왜곡.	역사/현실고증
굿굿 야한것도 좋앗지만 역사적 배경을 픽션화해서 더 재밌게 봤습니다	역사/현실고증
완전 신파. 불교에 대한 왜곡된 편견. 어떤 평론가가 좋다고 했는지 원.	역사/현실고증
스케일도 작고 역사왜곡은 심하게 하고 차라리 소설을쓰시치요????	역사/현실고증
역사 왜곡 쩔고 마초이즘도 아주 역겹던데. 보는 내내 기분이 좋지 않음.	역사/현실고증
작가 시각이 왜곡된거 아니예요	역사/현실고증
감독도 사과한 왜곡영화가 8점이라니 대한민국 국민들이 이리 무지했는가?	역사/현실고증
백제 왕실을 전라도 출신으로 만들어 버리는 최소한의 고증도 반영하지 못한 멍청한 영화... 스탭들의 노고 때문에 1점은 준다.	역사/현실고증
15년전 드라만데 요즘꺼보다 시대고증, 세트구성이 매우 치밀했다는걸 느낌	역사/현실고증
쪽발이들의 조센징에 대한 대표적인 역사왜곡과 잘못됀역사관을 심어주기위해 일류만화가을와 역사학자들을 동원해 만들어낸 만화,,,,그래도 재미있네 ,,,,그래도 평점은 많이 못주겟다 ,,, 나는 대한민국국민 이기에.,...	역사/현실고증
내가 이제껏 본 역사드라마 중 아니 드라마 중 최대 역작이다.철저한 역사적 고증을 토대로 한 디테일한 리얼리티와 픽션의 적절한 조화! 등장인물의 연기력 또한 빛난다! 마치 고대로마시대에 떨어진 듯한 느낌이 든다. 강력하게 추천하고 싶은 드라마!!!!!	역사/현실고증
사랑이란 감정을 왜곡한 앞뒤 안맞는 쓰레기 패미니즘 영화	역사/현실고증
고증 엉터리 투성이에 지루하다. 한반도보다 잼없다.	역사/현실고증
왜곡 너무 심하긴 하다...ㅉㅉ	역사/현실고증
소재가 되는 역사적 사건을 다루는데 집중하기 보다는 쓸데없는 멜로와 노출에만 신경 쓴다. 고증 따윈 전혀 신경 쓰지 않고, 혼란스러운 스토리엔 집중하기가 쉽지 않다.	역사/현실고증
크림슨 타이드에 일본 만화 침묵의 함대를 합한 아류작. 군사적 고증도 별로.	역사/현실고증
역사 왜곡 때문에 1점 드립니다. 광해는 대동법에 찬성하지도 않았고 북방민족이 발호 할 때 궁궐 심시티나 하던 암군입니다.	역사/현실고증
취지는 좋았다만 먼가 아쉬운 다큐... 차라리 안만들었는게 훨 나을뻔 했음.. 아님 진짜 역사스폐셜 같이 역사적 사실들을 더욱 디테일하게 살리던가.. 설민석 강사 영상이 훨 잼나군.. 고생만하고 결실이 없는 다큐인거 같음...	역사/현실고증
엄청나게 왜곡한 드라마 김치양은 역사에도 없었음	역사/현실고증
놈현낙하산 죄문순 사장 재임 당시라 그런지 왜곡이 존나게 많네 ㅋㅋㅋㅋㅋㅋㅋ	역사/현실고증
지들끼리 시나리오가 대박이네 연출 대단하네 연기 좋네 촬영 잘찍네 하면서 만들었을 영화...고증도 제대로 안되있고, 상황만 신파라...주요연기자들은 감정과잉이고 띄어읽기도 못하는 연기자들에..영화만드는거 즐거우면 혼자만들고 혼자 벽에 빔쏘고 보세요	역사/현실고증
역사적 배경을 알고 본다면 결코 나쁘지 않은 영화	역사/현실고증
정말 재미있게 보았음. 권력에는 친구도 의리도 없다는 역사적 사실을 훌륭하게 깨우쳐줌.	역사/현실고증
뛰어난 갑옷고증과 뛰어난 역사고증 거기다가 뛰어난 스토리!정말 완벽한 드라마네요.	역사/현실고증
보고나서 소름돋는 영화란 이런거다 미래예측부터 스릴감과 배우들의 연기력 훌륭한 고증은 2002년이 아닌 지금내도 명작이라고 해도 전혀 과장이 아닐것이다	역사/현실고증
'무엇'을 위한 욕망인가 확실히 보여준 영화. 역사적 사실을 바탕으로 한 상상력에 박수를 보낸다. 기이한 황음에 빠진 조선의 왕의 묘사에 보는 관점에 따라 잔인, 관음증, 포르노, 선정적 등 으로 비춰지겠지만 국왕의 폭정을 보여주기에 충분하다.	역사/현실고증
운석충돌 영화중 갑이다. 고증은 좀 떨어지지만.... 무튼 예쁜애랑 저렇게 쉽게 결혼하는건 참 부럽네.. 반지운반자의능력이란	역사/현실고증
실망스러운,노골적인 사실 왜곡이 느껴졌던! 편견으로 가득 >_신고	역사/현실고증
역사왜곡 OOO기 영화...	역사/현실고증
재미없어요 액션 오락성보단 실제 냉전시대 각 국의 정보기관의 생리, 그리고 실제 정보전의 고증을 그대로 표현한 현실성.. 다큐멘터리를 본 듯한 기분	역사/현실고증
그동안 길냥이들 많이 봐왔는데 그냥 지나쳤던 한스럽네요.. 이 다큐를 보면서 눈물도 나고 길냥이들의 고된삶이 너무나 불쌍하고 짠하고.. 앞으로는 항상 밖에 나갈때 길냥이 사료들 챙겨서 나가야겠다는 다짐을 하게 되었습니다..ㅜㅜ	역사/현실고증
계백이 호남 사투리를 쓰는 건 고증 오류. 계백은 충남 부여 출신임.	역사/현실고증
역사적 배경, 소몰이의 박진감, 로맨스, 이방인끼리의 가족애, 원주민의 영혼과 삶	역사/현실고증
이미연의 연기력과 드라마의 완성도만은 정말 손색없다.그러나 근본적으로 역사 왜곡.	역사/현실고증
전체적으로도 식민지배를 미화하는 부분도 문제지만 특히 결말부는 허구의 요코이야기를 보는듯해서 께름칙하다. 항복선언을 제대로 들은자도 없거니와 좋게 보내주었다는 사료들이 남아있는 작금에 왜 이딴식의 영화로 내선일체를 찬양하는지. 친일파 청산이 제대로 이	역사/현실고증
많은분들 말대로 현실성없고 사랑,연애라는것을 왜곡한 영화..	역사/현실고증
역사를 두고 만든 영화인데 아무리 영화라도 왜곡이 너무 심했다 영화를 잘만들기만 하면 단가? 페르시아 후손인 인도사람들 입장에선 무슨 생각이 들까? 한마디로 기본이 안된 양아치 같은 영화.	역사/현실고증
강제 징집되어 광훈은 천 태웅을 만난것이 천운 이었다.마지막 장면를 보고 나도 모르게 눈물이 흘렀다.그당시에 광주민중항쟁지나고 학생들은정부의 진실왜곡을 밝히고자 최루탄 콧물 지겹도록 흘렸는데!	역사/현실고증
전라도의 전형적인 역사왜곡 정치선동영화 1점도 아까움	역사/현실고증
"""솔직히 말한다. """"명량"""" 보다 낫다. 어떻게 이영화를 함부로 말하겠는가...그리고 역사적 고증 이야기하는 사람은 다큐를 보시라... 정작 다큐는 졸려서 안보는 인간들이 말이 많다."""	역사/현실고증
언제까지 이런 쓰레기 빨갱이 선동 역사왜곡 영화가 그만 나올련지, 빨간 성향을 가진 감독이 주입하는 빨간 역사왜곡.. 제주 4,3 사건은 명백한 남로당 반란 사건입니다. 국가를 전복시킬려고 한 이 사건이죠. 대한민국을 부정한 사건입니다.	역사/현실고증
역사왜곡이 너무 심해.. 김두한은 그냥 깡패일 뿐이라고...	역사/현실고증
영화 속 스토리에서 생생히 느껴지는 가슴 아픈 한국전의 역사적 사실... 전쟁의 아픔과 그속에서 적으로 만난 동족을 죽일 수 밖에 없는 현실.. 보는 내내 가슴이 먹먹했습니다.	역사/현실고증
혜성이 우주에서 움직이는 CG만 어색하지 나머지는 깜짝 놀랠 정도의 CG였다. 아마겟돈이 코미디 액션 SF라면 이건 드라마 SF라고 할 수 있겠네. 고증도 좋고 굳	역사/현실고증
고증과 사료 파괴 판타지 사극이 또 하는구나~ 노잼 ㅎ	역사/현실고증
재현의 힘이라니 왜곡의 힘이겠지, 이렇게 광주를 학살이라고 왜곡하니 폭동이라고 왜곡하는 놈들도 생기는 거다. 광주는 학살도 폭동도 아니고 민주화운동일뿐	역사/현실고증
아에 판타지를 만드는 편이 나았을듯..명색이 양반댁 여식이 일개 사공이란 천한직업과 다리를 들어내고 바다에서 놀지를 않나 또 왠 존대....평이 엇갈리는 명성왕후를 감독 잣대로 그린것 까지는 이해하나 요즘 드라마도 못한 고증으로 영화를 찍고 있으니	역사/현실고증
창작의 자유라는 이름하에 한 범죄 중 하나. 이런 영화를 만든 사람들은 범죄자라고 생각한다. 국민기만, 역사왜곡, 국가모독 으로 퇴출되야한다.	역사/현실고증
역사를 왜곡하는 쓰레기 애니메이션. 차라리 광주 민주화 항쟁을 폭동이라고 해라.	역사/현실고증
역사 왜곡을 정도 껏 해야지. 차라리 왜 사도가 미쳐가는지를 조명하던가 이건 뭐 판타지 소설에 영조랑 사도이름만 빌려 쓴거네	역사/현실고증
역사왜곡영화는 사라져야마땅하다	역사/현실고증
역사왜곡과 개념상실 접고 들어가면 즐기기에는 좋다	역사/현실고증
고증개판,스토리 지지부진한 전개, 밖으로는 고려사 10년 고의로 취소, 94년 소련문서에도 공개되어 종결된 남침유도설 등 음모론 설정 등 김재철보다 이상이면 이상이지 절대 이하가 아닌 정연주 사장의 정치적 방송놀이-_-	역사/현실고증
